periodo;regiao;instituicao;urgencias_gerais;urgencias_pediatricas;urgencias_obstetricas;urgencias_psiquiatricas;total_urgencias
2024-01-01;Região de Saúde LVT;Unidade Local de Saúde da Arrábida;5433;2425;515;0;8373
2024-01-01;Região de Saúde Norte;Unidade Local de Saúde da Póvoa de Varzim/Vila do Conde;5536;0;0;0;5536
2024-01-01;Região de Saúde LVT;Unidade Local de Saúde de Amadora/Sintra;13917;3268;1303;0;18488
2024-01-01;Região de Saúde Norte;Unidade Local de Saúde de Braga;11752;4087;998;0;16837
2024-01-01;Região de Saúde Norte;Unidade Local de Saúde de Entre Douro e Vouga;15899;2720;630;0;19249
2024-01-01;Região de Saúde Norte;Unidade Local de Saúde de Matosinhos;6206;0;615;0;6821
2024-01-01;Região de Saúde LVT;Unidade Local de Saúde do Médio Tejo;8830;1827;328;0;10985
2025-01-01;Região de Saúde LVT;Unidade Local de Saúde da Lezíria;6310;2423;502;0;9235
2025-01-01;Região de Saúde Norte;Unidade Local de Saúde da Póvoa de Varzim/Vila do Conde;5561;0;0;0;5561
2025-01-01;Região de Saúde Centro;Unidade Local de Saúde da Região de Leiria;9564;2406;581;0;12551
2025-01-01;Região de Saúde Norte;Unidade Local de Saúde de Entre Douro e Vouga;12394;2115;573;0;15082
2025-01-01;Região de Saúde Norte;Unidade Local de Saúde de Vila Nova de Gaia/Espinho;11119;3381;612;0;15112
2025-01-01;Região de Saúde Norte;Unidade Local de Saúde do Alto Minho;9737;1640;510;0;11887
2025-01-01;Região de Saúde LVT;Unidade Local de Saúde do Estuário do Tejo;6191;3880;505;0;10576
2024-02-01;Região de Saúde Centro;Unidade Local de Saúde da Região de Aveiro;18709;7382;915;0;27006
2024-02-01;Região de Saúde Centro;Unidade Local de Saúde da Região de Leiria;19580;5044;1532;0;26156
2024-02-01;Região de Saúde Norte;Unidade Local de Saúde de Barcelos/Esposende;8199;2453;0;0;10652
2024-02-01;Região de Saúde Centro;Unidade Local de Saúde de Dão-Lafões;17289;5980;2198;0;25467
2024-02-01;Região de Saúde LVT;Unidade Local de Saúde de Loures-Odivelas;11236;4468;2733;0;18437
2024-02-01;Região de Saúde LVT;Unidade Local de Saúde de Santa Maria;20092;7690;148;0;27930
2024-02-01;Região de Saúde Norte;Unidade Local de Saúde de Santo António;19273;0;3200;0;22473
2024-02-01;Região de Saúde LVT;Unidade Local de Saúde de São José;21143;14139;3913;1005;40200
2024-02-01;Região de Saúde Norte;Unidade Local de Saúde do Alto Ave;15976;5798;1538;0;23312
2024-02-01;Região de Saúde Norte;Unidade Local de Saúde do Alto Minho;21666;3654;1052;0;26372
2024-02-01;Região de Saúde Centro;Unidade Local de Saúde do Baixo Mondego;7890;3348;0;0;11238
2024-02-01;Região de Saúde Alentejo;Unidade Local de Saúde do Litoral Alentejano;0;0;0;0;0
2024-02-01;Região de Saúde Norte;Unidade Local de Saúde do Médio Ave;13529;5665;1120;0;20314
2025-02-01;Região de Saúde Centro;Unidade Local de Saúde da Guarda;13655;3084;591;0;17330
2025-02-01;Região de Saúde Norte;Unidade Local de Saúde de Braga;22122;6881;1809;0;30812
2025-02-01;Região de Saúde Centro;Unidade Local de Saúde de Dão-Lafões;21157;5306;2194;0;28657
2025-02-01;Região de Saúde Norte;Unidade Local de Saúde de Vila Nova de Gaia/Espinho;21729;6498;1220;0;29447
2025-02-01;Região de Saúde Alentejo;Unidade Local de Saúde do Baixo Alentejo;15658;3525;681;0;19864
2025-02-01;Região de Saúde LVT;Unidade Local de Saúde do Médio Tejo;18899;5223;556;0;24678
2024-03-01;Região de Saúde Centro;Unidade Local de Saúde da Cova da Beira;11647;4289;953;74;16963
2024-03-01;Região de Saúde LVT;Unidade Local de Saúde da Lezíria;18388;7862;1802;0;28052
2024-03-01;Região de Saúde Centro;Unidade Local de Saúde da Região de Leiria;30274;7891;2350;0;40515
2024-03-01;Região de Saúde Norte;Unidade Local de Saúde de Braga;36308;13096;2813;0;52217
2024-03-01;Região de Saúde LVT;Unidade Local de Saúde de Lisboa Ocidental;21153;8049;3457;0;32659
2024-03-01;Região de Saúde Norte;Unidade Local de Saúde de São João;40363;20793;3022;0;64178
2024-03-01;Região de Saúde Norte;Unidade Local de Saúde de Trás-os-Montes e Alto Douro;44658;8364;1411;0;54433
2024-03-01;Região de Saúde Algarve;Unidade Local de Saúde do Algarve;65478;18015;4494;0;87987
2024-03-01;Região de Saúde LVT;Unidade Local de Saúde do Arco Ribeirinho;28286;5646;1801;0;35733
2024-03-01;Região de Saúde Centro;Unidade Local de Saúde do Baixo Mondego;12232;5344;0;0;17576
2024-03-01;Região de Saúde Alentejo;Unidade Local de Saúde do Litoral Alentejano;23945;0;0;0;23945
2024-03-01;Região de Saúde LVT;Unidade Local de Saúde do Oeste;28566;12984;1414;0;42964
2024-04-01;Região de Saúde LVT;Hospital de Cascais;26761;16395;5315;294;48765
2024-04-01;Região de Saúde Norte;Unidade Local de Saúde da Póvoa de Varzim/Vila do Conde;23064;0;0;0;23064
2024-04-01;Região de Saúde Centro;Unidade Local de Saúde da Região de Aveiro;40361;16349;1955;0;58665
2024-04-01;Região de Saúde Norte;Unidade Local de Saúde de Matosinhos;26926;0;2786;0;29712
2024-04-01;Região de Saúde Alentejo;Unidade Local de Saúde do Alentejo Central;14785;6160;0;0;20945
2024-04-01;Região de Saúde Alentejo;Unidade Local de Saúde do Alto Alentejo;25900;3085;859;0;29844
2024-04-01;Região de Saúde LVT;Unidade Local de Saúde do Arco Ribeirinho;38399;7523;2331;0;48253
2024-04-01;Região de Saúde LVT;Unidade Local de Saúde do Médio Tejo;37561;9435;1261;0;48257
2024-04-01;Região de Saúde Norte;Unidade Local de Saúde do Nordeste;34204;0;0;0;34204
2024-05-01;Região de Saúde Centro;Unidade Local de Saúde da Guarda;33512;7294;1598;0;42404
2024-05-01;Região de Saúde Centro;Unidade Local de Saúde de Dão-Lafões;46642;14875;6012;0;67529
2024-05-01;Região de Saúde Norte;Unidade Local de Saúde de Entre Douro e Vouga;70714;14457;3082;0;88253
2024-05-01;Região de Saúde Norte;Unidade Local de Saúde de São João;70504;36485;5263;0;112252
2024-05-01;Região de Saúde Alentejo;Unidade Local de Saúde do Alentejo Central;18971;8208;0;0;27179
2024-05-01;Região de Saúde Alentejo;Unidade Local de Saúde do Baixo Alentejo;40172;8382;1647;0;50201
2024-05-01;Região de Saúde Centro;Unidade Local de Saúde do Baixo Mondego;21086;9144;0;0;30230
2024-05-01;Região de Saúde LVT;Unidade Local de Saúde do Médio Tejo;48334;12128;1677;0;62139
2024-05-01;Região de Saúde Norte;Unidade Local de Saúde do Nordeste;43794;0;0;0;43794
2024-06-01;Região de Saúde Norte;Unidade Local de Saúde da Póvoa de Varzim/Vila do Conde;34415;0;0;0;34415
2024-06-01;Região de Saúde LVT;Unidade Local de Saúde de Amadora/Sintra;90883;26412;8782;0;126077
2024-06-01;Região de Saúde Centro;Unidade Local de Saúde de Coimbra;100819;36220;11508;0;148547
2024-06-01;Região de Saúde LVT;Unidade Local de Saúde de Loures-Odivelas;36087;13652;7744;0;57483
2024-06-01;Região de Saúde Alentejo;Unidade Local de Saúde do Alentejo Central;22841;9870;0;0;32711
2024-06-01;Região de Saúde Norte;Unidade Local de Saúde do Alto Minho;70608;11537;3410;0;85555
2024-06-01;Região de Saúde LVT;Unidade Local de Saúde do Médio Tejo;58821;14510;2040;0;75371
2024-06-01;Região de Saúde Norte;Unidade Local de Saúde do Nordeste;52686;0;0;0;52686
2024-07-01;Região de Saúde LVT;Unidade Local de Saúde da Arrábida;42557;18640;4361;0;65558
2024-07-01;Região de Saúde Centro;Unidade Local de Saúde da Guarda;47919;9885;2337;0;60141
2024-07-01;Região de Saúde LVT;Unidade Local de Saúde de Almada-Seixal;53798;23340;8734;0;85872
2024-07-01;Região de Saúde Centro;Unidade Local de Saúde de Coimbra;118476;41108;13569;0;173153
2024-07-01;Região de Saúde LVT;Unidade Local de Saúde de Loures-Odivelas;42200;15150;8988;0;66338
2024-07-01;Região de Saúde Norte;Unidade Local de Saúde de Matosinhos;48603;0;5138;0;53741
2024-07-01;Região de Saúde LVT;Unidade Local de Saúde do Estuário do Tejo;48384;28570;4410;0;81364
2024-07-01;Região de Saúde LVT;Unidade Local de Saúde do Oeste;69817;30561;3809;0;104187
2024-08-01;Região de Saúde Centro;Unidade Local de Saúde da Região de Leiria;82828;17282;5735;0;105845
2024-08-01;Região de Saúde LVT;Unidade Local de Saúde de Amadora/Sintra;121484;33416;12060;0;166960
2024-08-01;Região de Saúde Algarve;Unidade Local de Saúde do Algarve;198771;50191;11112;0;260074
2024-08-01;Região de Saúde Centro;Unidade Local de Saúde do Baixo Mondego;35019;13606;0;0;48625
2024-08-01;Região de Saúde LVT;Unidade Local de Saúde do Estuário do Tejo;55169;31189;5274;0;91632
2024-08-01;Região de Saúde Norte;Unidade Local de Saúde do Tâmega e Sousa;107106;25056;8637;0;140799
2024-09-01;Região de Saúde Centro;Unidade Local de Saúde Castelo Branco;40605;12479;1756;0;54840
2024-09-01;Região de Saúde Norte;Unidade Local de Saúde da Póvoa de Varzim/Vila do Conde;50192;0;0;0;50192
2024-09-01;Região de Saúde Centro;Unidade Local de Saúde da Região de Aveiro;93569;34171;4853;0;132593
2024-09-01;Região de Saúde Centro;Unidade Local de Saúde de Coimbra;151903;50544;17747;0;220194
2024-09-01;Região de Saúde Centro;Unidade Local de Saúde de Dão-Lafões;85912;22062;11186;0;119160
2024-09-01;Região de Saúde Norte;Unidade Local de Saúde de Entre Douro e Vouga;121505;21949;5431;0;148885
2024-09-01;Região de Saúde Norte;Unidade Local de Saúde de Matosinhos;62107;0;6720;0;68827
2024-09-01;Região de Saúde Norte;Unidade Local de Saúde de Santo António;95575;0;15213;0;110788
2024-09-01;Região de Saúde Norte;Unidade Local de Saúde de São João;129103;59588;9593;0;198284
2024-09-01;Região de Saúde Norte;Unidade Local de Saúde de Trás-os-Montes e Alto Douro;148404;23388;4087;0;175879
2024-10-01;Região de Saúde Norte;Unidade Local de Saúde da Póvoa de Varzim/Vila do Conde;55896;0;0;0;55896
2024-10-01;Região de Saúde Centro;Unidade Local de Saúde da Região de Leiria;103136;20845;7082;0;131063
2024-10-01;Região de Saúde LVT;Unidade Local de Saúde de Lisboa Ocidental;75557;24995;10300;0;110852
2024-10-01;Região de Saúde LVT;Unidade Local de Saúde de Loures-Odivelas;59776;20356;12156;0;92288
2024-10-01;Região de Saúde Norte;Unidade Local de Saúde de São João;143801;66840;10680;0;221321
2024-10-01;Região de Saúde Norte;Unidade Local de Saúde do Nordeste;88267;0;0;0;88267
2024-11-01;Região de Saúde Norte;Unidade Local de Saúde da Póvoa de Varzim/Vila do Conde;61871;0;0;0;61871
2024-11-01;Região de Saúde LVT;Unidade Local de Saúde de Amadora/Sintra;167352;47021;17013;0;231386
2024-11-01;Região de Saúde Centro;Unidade Local de Saúde de Dão-Lafões;106828;26610;13644;0;147082
2024-11-01;Região de Saúde LVT;Unidade Local de Saúde de São José;126281;76003;22631;5788;230703
2024-11-01;Região de Saúde Norte;Unidade Local de Saúde de Trás-os-Montes e Alto Douro;179363;28727;4944;0;213034
2024-11-01;Região de Saúde Alentejo;Unidade Local de Saúde do Baixo Alentejo;86189;16996;3854;0;107039
2024-11-01;Região de Saúde Norte;Unidade Local de Saúde do Tâmega e Sousa;149349;33259;11731;0;194339
2024-12-01;Região de Saúde Centro;Unidade Local de Saúde da Cova da Beira;49632;17230;3952;451;71265
2024-12-01;Região de Saúde Norte;Unidade Local de Saúde da Póvoa de Varzim/Vila do Conde;67746;0;0;0;67746
2024-12-01;Região de Saúde Centro;Unidade Local de Saúde da Região de Leiria;122168;24684;8280;0;155132
2024-12-01;Região de Saúde LVT;Unidade Local de Saúde de Amadora/Sintra;181997;52557;18521;0;253075
2024-12-01;Região de Saúde Centro;Unidade Local de Saúde de Coimbra;200563;67895;23479;0;291937
2024-12-01;Região de Saúde Norte;Unidade Local de Saúde do Alto Minho;142935;21525;6854;0;171314
2024-12-01;Região de Saúde Alentejo;Unidade Local de Saúde do Litoral Alentejano;102955;0;0;0;102955
2024-01-01;Região de Saúde Centro;Unidade Local de Saúde Castelo Branco;4252;1445;188;0;5885
2024-01-01;Região de Saúde Centro;Unidade Local de Saúde da Cova da Beira;3895;1443;295;42;5675
2024-01-01;Região de Saúde LVT;Unidade Local de Saúde da Lezíria;5647;2282;570;0;8499
2024-01-01;Região de Saúde LVT;Unidade Local de Saúde de Santa Maria;9577;3752;53;0;13382
2024-01-01;Região de Saúde Norte;Unidade Local de Saúde de Santo António;9644;0;1594;0;11238
2024-01-01;Região de Saúde Norte;Unidade Local de Saúde de Trás-os-Montes e Alto Douro;14981;2852;475;0;18308
2024-01-01;Região de Saúde Algarve;Unidade Local de Saúde do Algarve;21938;5514;1432;0;28884
2024-01-01;Região de Saúde Alentejo;Unidade Local de Saúde do Alto Alentejo;6586;751;206;0;7543
2024-01-01;Região de Saúde Norte;Unidade Local de Saúde do Alto Ave;8050;2692;806;0;11548
2024-01-01;Região de Saúde Norte;Unidade Local de Saúde do Alto Minho;11259;1696;536;0;13491
2025-01-01;Região de Saúde Centro;Unidade Local de Saúde Castelo Branco;4412;1477;244;0;6133
2025-01-01;Região de Saúde Norte;Unidade Local de Saúde de Braga;11339;3362;943;0;15644
2025-01-01;Região de Saúde LVT;Unidade Local de Saúde de Santa Maria;9687;3786;1153;0;14626
2025-01-01;Região de Saúde Norte;Unidade Local de Saúde de Santo António;9888;0;1303;0;11191
2025-01-01;Região de Saúde LVT;Unidade Local de Saúde de São José;10440;6548;1609;428;19025
2025-01-01;Região de Saúde Norte;Unidade Local de Saúde de Trás-os-Montes e Alto Douro;16292;2809;415;0;19516
2025-01-01;Região de Saúde Alentejo;Unidade Local de Saúde do Alentejo Central;4224;1655;0;0;5879
2025-01-01;Região de Saúde Norte;Unidade Local de Saúde do Alto Ave;8376;2426;809;0;11611
2025-01-01;Região de Saúde LVT;Unidade Local de Saúde do Arco Ribeirinho;9422;2337;613;0;12372
2025-01-01;Região de Saúde Alentejo;Unidade Local de Saúde do Baixo Alentejo;8417;1867;367;0;10651
2025-01-01;Região de Saúde Norte;Unidade Local de Saúde do Tâmega e Sousa;14093;2879;985;0;17957
2024-02-01;Região de Saúde Norte;Unidade Local de Saúde da Póvoa de Varzim/Vila do Conde;11014;0;0;0;11014
2024-02-01;Região de Saúde Norte;Unidade Local de Saúde de Entre Douro e Vouga;28482;5787;1278;0;35547
2024-02-01;Região de Saúde Norte;Unidade Local de Saúde de Matosinhos;12520;0;1257;0;13777
2024-02-01;Região de Saúde Norte;Unidade Local de Saúde de Vila Nova de Gaia/Espinho;20459;6874;1318;0;28651
2024-02-01;Região de Saúde LVT;Unidade Local de Saúde do Estuário do Tejo;12503;8073;1315;0;21891
2024-02-01;Região de Saúde Norte;Unidade Local de Saúde do Tâmega e Sousa;22394;5425;1927;0;29746
2025-02-01;Região de Saúde LVT;Hospital de Cascais;13859;7357;2393;130;23739
2025-02-01;Região de Saúde Centro;Unidade Local de Saúde da Região de Aveiro;19008;6871;1114;0;26993
2025-02-01;Região de Saúde LVT;Unidade Local de Saúde de Almada-Seixal;13742;5792;1653;0;21187
2025-02-01;Região de Saúde Norte;Unidade Local de Saúde de Matosinhos;12191;0;1331;0;13522
2025-02-01;Região de Saúde Norte;Unidade Local de Saúde de Santo António;19272;0;2378;0;21650
2025-02-01;Região de Saúde LVT;Unidade Local de Saúde de São José;20450;12432;3209;889;36980
2025-02-01;Região de Saúde Norte;Unidade Local de Saúde de Trás-os-Montes e Alto Douro;31332;5440;797;0;37569
2025-02-01;Região de Saúde Norte;Unidade Local de Saúde do Alto Minho;18709;3402;953;0;23064
2025-02-01;Região de Saúde Alentejo;Unidade Local de Saúde do Litoral Alentejano;15001;0;0;0;15001
2024-03-01;Região de Saúde Centro;Unidade Local de Saúde Castelo Branco;12757;4469;581;0;17807
2024-03-01;Região de Saúde Norte;Unidade Local de Saúde da Póvoa de Varzim/Vila do Conde;17147;0;0;0;17147
2024-03-01;Região de Saúde Norte;Unidade Local de Saúde de Entre Douro e Vouga;44439;8987;1899;0;55325
2024-03-01;Região de Saúde Norte;Unidade Local de Saúde de Matosinhos;19628;0;1995;0;21623
2024-03-01;Região de Saúde Norte;Unidade Local de Saúde de Santo António;30120;0;4958;0;35078
2024-04-01;Região de Saúde Centro;Unidade Local de Saúde da Cova da Beira;16001;5920;1259;140;23320
2024-04-01;Região de Saúde LVT;Unidade Local de Saúde da Lezíria;25189;10717;2495;0;38401
2024-04-01;Região de Saúde LVT;Unidade Local de Saúde de Almada-Seixal;29420;13376;5600;0;48396
2024-04-01;Região de Saúde Norte;Unidade Local de Saúde de Barcelos/Esposende;17158;5093;0;0;22251
2024-04-01;Região de Saúde Norte;Unidade Local de Saúde de Braga;49293;17482;3775;0;70550
2024-04-01;Região de Saúde Centro;Unidade Local de Saúde de Dão-Lafões;36538;11686;4704;0;52928
2024-04-01;Região de Saúde LVT;Unidade Local de Saúde de Loures-Odivelas;23599;9417;5542;0;38558
2024-04-01;Região de Saúde Norte;Unidade Local de Saúde de São João;55187;28426;4103;0;87716
2024-04-01;Região de Saúde Norte;Unidade Local de Saúde do Alto Ave;33409;12819;3291;0;49519
2024-04-01;Região de Saúde Alentejo;Unidade Local de Saúde do Litoral Alentejano;32994;0;0;0;32994
2024-05-01;Região de Saúde Centro;Unidade Local de Saúde Castelo Branco;22478;7819;942;0;31239
2024-05-01;Região de Saúde LVT;Unidade Local de Saúde da Arrábida;30005;13896;3146;0;47047
2024-05-01;Região de Saúde LVT;Unidade Local de Saúde da Lezíria;32171;13720;3181;0;49072
2024-05-01;Região de Saúde Centro;Unidade Local de Saúde da Região de Aveiro;51865;21193;2517;0;75575
2024-05-01;Região de Saúde Norte;Unidade Local de Saúde de Braga;62649;22098;4794;0;89541
2024-05-01;Região de Saúde Centro;Unidade Local de Saúde de Coimbra;83632;30455;9544;0;123631
2024-05-01;Região de Saúde LVT;Unidade Local de Saúde de Santa Maria;56892;21521;1311;0;79724
2024-05-01;Região de Saúde Algarve;Unidade Local de Saúde do Algarve;116240;32095;6850;0;155185
2024-05-01;Região de Saúde Norte;Unidade Local de Saúde do Alto Ave;42461;16949;4225;0;63635
2024-05-01;Região de Saúde LVT;Unidade Local de Saúde do Arco Ribeirinho;48827;9399;2934;0;61160
2024-06-01;Região de Saúde Centro;Unidade Local de Saúde Castelo Branco;27154;9249;1173;0;37576
2024-06-01;Região de Saúde LVT;Unidade Local de Saúde da Lezíria;38574;16257;3750;0;58581
2024-06-01;Região de Saúde Centro;Unidade Local de Saúde da Região de Aveiro;62380;24922;3008;0;90310
2024-06-01;Região de Saúde LVT;Unidade Local de Saúde de Almada-Seixal;45668;20611;7756;0;74035
2024-06-01;Região de Saúde Norte;Unidade Local de Saúde de Braga;75999;26206;5860;0;108065
2024-06-01;Região de Saúde Norte;Unidade Local de Saúde de Entre Douro e Vouga;83667;16732;3661;0;104060
2024-06-01;Região de Saúde Norte;Unidade Local de Saúde do Tâmega e Sousa;76536;20097;6335;0;102968
2024-07-01;Região de Saúde Norte;Unidade Local de Saúde de Entre Douro e Vouga;97019;18673;4287;0;119979
2024-07-01;Região de Saúde LVT;Unidade Local de Saúde de Santa Maria;81551;28884;2974;0;113409
2024-07-01;Região de Saúde Algarve;Unidade Local de Saúde do Algarve;169148;43983;9437;0;222568
2024-07-01;Região de Saúde Alentejo;Unidade Local de Saúde do Baixo Alentejo;56252;11509;2408;0;70169
2024-07-01;Região de Saúde Centro;Unidade Local de Saúde do Baixo Mondego;30131;12217;0;0;42348
2024-07-01;Região de Saúde Norte;Unidade Local de Saúde do Médio Ave;51258;20683;4142;0;76083
2024-08-01;Região de Saúde Norte;Unidade Local de Saúde da Póvoa de Varzim/Vila do Conde;45147;0;0;0;45147
2024-08-01;Região de Saúde Norte;Unidade Local de Saúde de Braga;102985;32865;7697;0;143547
2024-08-01;Região de Saúde Centro;Unidade Local de Saúde de Dão-Lafões;76871;20519;9939;0;107329
2024-08-01;Região de Saúde Norte;Unidade Local de Saúde de Trás-os-Montes e Alto Douro;133701;21552;3651;0;158904
2024-08-01;Região de Saúde Alentejo;Unidade Local de Saúde do Alentejo Central;30671;12090;0;0;42761
2024-08-01;Região de Saúde Alentejo;Unidade Local de Saúde do Alto Alentejo;54097;6121;1862;0;62080
2024-08-01;Região de Saúde Norte;Unidade Local de Saúde do Médio Ave;58331;22487;4795;0;85613
2024-08-01;Região de Saúde Norte;Unidade Local de Saúde do Nordeste;71588;0;0;0;71588
2024-08-01;Região de Saúde LVT;Unidade Local de Saúde do Oeste;80210;33446;4202;0;117858
2024-09-01;Região de Saúde Centro;Unidade Local de Saúde da Guarda;62016;12120;3015;0;77151
2024-09-01;Região de Saúde Norte;Unidade Local de Saúde de Barcelos/Esposende;39909;10328;0;0;50237
2024-09-01;Região de Saúde LVT;Unidade Local de Saúde de Loures-Odivelas;53599;17838;11069;0;82506
2024-09-01;Região de Saúde Norte;Unidade Local de Saúde de Vila Nova de Gaia/Espinho;99458;28850;6150;0;134458
2024-09-01;Região de Saúde Alentejo;Unidade Local de Saúde do Alto Alentejo;60450;6733;2097;0;69280
2024-09-01;Região de Saúde Alentejo;Unidade Local de Saúde do Litoral Alentejano;77711;0;0;0;77711
2024-10-01;Região de Saúde Centro;Unidade Local de Saúde da Cova da Beira;41889;14191;3347;361;59788
2024-10-01;Região de Saúde Centro;Unidade Local de Saúde da Região de Aveiro;104320;38531;5512;0;148363
2024-10-01;Região de Saúde Centro;Unidade Local de Saúde de Coimbra;169081;56510;19659;0;245250
2024-10-01;Região de Saúde Norte;Unidade Local de Saúde de Entre Douro e Vouga;134439;24104;6120;0;164663
2024-10-01;Região de Saúde LVT;Unidade Local de Saúde de Santa Maria;115864;39971;6283;0;162118
2024-10-01;Região de Saúde Alentejo;Unidade Local de Saúde do Alto Alentejo;66464;7562;2299;0;76325
2024-10-01;Região de Saúde Centro;Unidade Local de Saúde do Baixo Mondego;43118;16615;0;0;59733
2024-10-01;Região de Saúde Alentejo;Unidade Local de Saúde do Litoral Alentejano;86470;0;0;0;86470
2024-10-01;Região de Saúde Norte;Unidade Local de Saúde do Médio Ave;72272;27445;6074;0;105791
2024-11-01;Região de Saúde Norte;Unidade Local de Saúde de Braga;139876;44969;10596;0;195441
2024-11-01;Região de Saúde Norte;Unidade Local de Saúde de Santo António;116628;0;18644;0;135272
2024-11-01;Região de Saúde Norte;Unidade Local de Saúde de São João;158008;74195;11753;0;243956
2024-11-01;Região de Saúde Norte;Unidade Local de Saúde de Vila Nova de Gaia/Espinho;122408;36262;7436;0;166106
2024-11-01;Região de Saúde LVT;Unidade Local de Saúde do Médio Tejo;109995;25518;3898;0;139411
2024-11-01;Região de Saúde Norte;Unidade Local de Saúde do Nordeste;97228;0;0;0;97228
2024-12-01;Região de Saúde LVT;Unidade Local de Saúde de Almada-Seixal;93031;39139;12095;0;144265
2024-12-01;Região de Saúde Norte;Unidade Local de Saúde de Braga;151911;49962;11613;0;213486
2024-12-01;Região de Saúde Norte;Unidade Local de Saúde de Entre Douro e Vouga;159723;29372;7202;0;196297
2024-12-01;Região de Saúde LVT;Unidade Local de Saúde de Lisboa Ocidental;90951;31349;12294;0;134594
2024-12-01;Região de Saúde LVT;Unidade Local de Saúde de Loures-Odivelas;71102;25125;14154;0;110381
2024-12-01;Região de Saúde LVT;Unidade Local de Saúde de São José;137146;83743;24206;6231;251326
2024-12-01;Região de Saúde Norte;Unidade Local de Saúde de Vila Nova de Gaia/Espinho;133701;40712;8091;0;182504
2024-12-01;Região de Saúde Alentejo;Unidade Local de Saúde do Alentejo Central;47625;17953;0;0;65578
2024-12-01;Região de Saúde LVT;Unidade Local de Saúde do Estuário do Tejo;75072;49244;7852;0;132168
2024-12-01;Região de Saúde LVT;Unidade Local de Saúde do Oeste;118497;51641;6667;0;176805
2019-01-01;Região de Saúde Centro;Centro Hospitalar Universitário Cova da Beira;4375;1744;305;0;6424
2019-01-01;Região de Saúde Centro;Centro Hospitalar de Leiria;12043;3721;1096;0;16860
2019-01-01;Região de Saúde Centro;Centro Hospitalar e Universitário de Coimbra;17600;6775;2258;0;26633
2019-01-01;Região de Saúde Centro;Unidade Local de Saúde de Castelo Branco;4371;1063;151;0;5585
2019-01-01;Região de Saúde LVT;Centro Hospitalar Barreiro/Montijo;9573;3835;852;0;14260
2019-01-01;Região de Saúde LVT;Centro Hospitalar Universitário Lisboa Central;11815;7549;1753;490;21607
2019-01-01;Região de Saúde LVT;Hospital Professor Doutor Fernando Fonseca;15807;5799;1758;0;23364
2019-01-01;Região de Saúde Norte;Centro Hospitalar Tâmega e Sousa;11915;3656;1172;0;16743
2019-01-01;Região de Saúde Norte;Hospital de Braga;12646;4548;1451;0;18645
2019-01-01;Região de Saúde Norte;Unidade Local de Saúde do Alto Minho;11849;2099;538;0;14486
2019-01-01;Região de Saúde Norte;Unidade Local de Saúde do Nordeste;10312;0;0;0;10312
2019-02-01;Região de Saúde Alentejo;Hospital Espírito Santo de Évora;8945;3890;0;0;12835
2019-02-01;Região de Saúde Centro;Centro Hospitalar de Leiria;22806;6414;2022;0;31242
2019-02-01;Região de Saúde Centro;Centro Hospitalar do Baixo Vouga;21146;7554;1089;0;29789
2019-02-01;Região de Saúde Centro;Centro Hospitalar e Universitário de Coimbra;33807;12191;4230;0;50228
2019-02-01;Região de Saúde LVT;Centro Hospitalar de Setúbal;14663;7594;2036;0;24293
2019-02-01;Região de Saúde Norte;Centro Hospitalar Universitário de São João;26080;14150;2320;0;42550
2019-02-01;Região de Saúde Norte;Centro Hospitalar Entre Douro e Vouga;29019;6147;1488;0;36654
2019-02-01;Região de Saúde Norte;Centro Hospitalar Trás-os-Montes e Alto Douro;24899;5766;721;0;31386
2019-03-01;Região de Saúde Alentejo;Unidade Local de Saúde do Norte Alentejano;20843;2215;343;0;23401
2019-03-01;Região de Saúde Centro;Centro Hospitalar e Universitário de Coimbra;51272;17693;6138;0;75103
2019-03-01;Região de Saúde Centro;Centro Hospitalar Tondela-Viseu;26733;8889;3742;0;39364
2019-03-01;Região de Saúde Centro;Unidade Local de Saúde da Guarda;20591;4254;901;0;25746
2019-03-01;Região de Saúde LVT;Centro Hospitalar Universitário Lisboa Central;34497;20625;5276;1558;61956
2019-03-01;Região de Saúde LVT;Centro Hospitalar de Setúbal;22466;11096;3201;0;36763
2019-03-01;Região de Saúde LVT;Centro Hospitalar do Oeste;30273;13292;2481;0;46046
2019-03-01;Região de Saúde LVT;Hospital Garcia de Orta;25030;12220;4228;0;41478
2019-03-01;Região de Saúde Norte;Hospital de Braga;38024;13550;3991;0;55565
2019-03-01;Região de Saúde Norte;Unidade Local de Saúde do Nordeste;29057;0;0;0;29057
2019-04-01;Região de Saúde Centro;Centro Hospitalar e Universitário de Coimbra;67884;22602;8203;0;98689
2019-04-01;Região de Saúde Centro;Hospital Distrital da Figueira da Foz;17519;6526;0;0;24045
2019-04-01;Região de Saúde Centro;Unidade Local de Saúde de Castelo Branco;17004;3840;567;0;21411
2019-04-01;Região de Saúde LVT;Hospital de Loures;39669;21174;5764;0;66607
2019-04-01;Região de Saúde LVT;Hospital Distrital de Santarém;30476;11835;2869;0;45180
2019-04-01;Região de Saúde Norte;Centro Hospitalar Póvoa de Varzim/Vila do Conde;24517;0;0;0;24517
2019-04-01;Região de Saúde Norte;Hospital de Braga;50535;17111;5345;0;72991
2019-04-01;Região de Saúde Norte;Unidade Local de Saúde de Matosinhos;25734;0;3440;0;29174
2019-04-01;Região de Saúde Norte;Unidade Local de Saúde do Nordeste;37543;0;0;0;37543
2019-05-01;Região de Saúde Alentejo;Unidade Local de Saúde do Baixo Alentejo;36798;7571;1469;0;45838
2019-05-01;Região de Saúde Alentejo;Unidade Local de Saúde do Litoral Alentejano;38516;0;0;0;38516
2019-05-01;Região de Saúde Alentejo;Unidade Local de Saúde do Norte Alentejano;34132;3534;543;0;38209
2019-05-01;Região de Saúde Centro;Hospital Distrital da Figueira da Foz;21936;8159;0;0;30095
2019-05-01;Região de Saúde LVT;Centro Hospitalar de Setúbal;37919;17665;5452;0;61036
2019-05-01;Região de Saúde LVT;Hospital de Vila Franca de Xira;35766;19578;4182;0;59526
2019-05-01;Região de Saúde Norte;Centro Hospitalar Universitário de São João;68349;32734;5952;0;107035
2019-05-01;Região de Saúde Norte;Centro Hospitalar Entre Douro e Vouga;71444;13733;3735;0;88912
2019-05-01;Região de Saúde Norte;Unidade Local de Saúde do Nordeste;46756;0;0;0;46756
2019-06-01;Região de Saúde Alentejo;Unidade Local de Saúde do Litoral Alentejano;45983;0;0;0;45983
2019-06-01;Região de Saúde Centro;Hospital Distrital da Figueira da Foz;26450;9606;0;0;36056
2019-06-01;Região de Saúde LVT;Centro Hospitalar Barreiro/Montijo;53583;19184;5324;0;78091
2019-06-01;Região de Saúde LVT;Hospital de Loures;59957;30913;8860;0;99730
2019-06-01;Região de Saúde LVT;Hospital Professor Doutor Fernando Fonseca;89787;28960;10538;0;129285
2019-06-01;Região de Saúde Norte;Hospital Santa Maria Maior;24436;7206;0;0;31642
2019-07-01;Região de Saúde LVT;Hospital Garcia de Orta;60194;25819;10186;0;96199
2019-07-01;Região de Saúde Norte;Centro Hospitalar do Médio Ave;54031;19533;4292;0;77856
2019-07-01;Região de Saúde Norte;Centro Hospitalar Trás-os-Montes e Alto Douro;86326;16546;2703;0;105575
2019-07-01;Região de Saúde Norte;Unidade Local de Saúde do Alto Minho;79905;11706;3812;0;95423
2019-08-01;Região de Saúde LVT;Centro Hospitalar Médio Tejo;78112;18082;1971;0;98165
2019-08-01;Região de Saúde LVT;Hospital Distrital de Santarém;57550;24330;5459;0;87339
2019-08-01;Região de Saúde Norte;Centro Hospitalar do Médio Ave;61478;21412;4942;0;87832
2019-08-01;Região de Saúde Norte;Centro Hospitalar Entre Douro e Vouga;115428;19972;6248;0;141648
2019-09-01;Região de Saúde Alentejo;Unidade Local de Saúde do Litoral Alentejano;70721;0;0;0;70721
2019-09-01;Região de Saúde Algarve;Centro Hospitalar Universitário do Algarve;203344;54733;16501;0;274578
2019-09-01;Região de Saúde Centro;Centro Hospitalar de Leiria;105200;24097;9845;0;139142
2019-09-01;Região de Saúde Centro;Centro Hospitalar do Baixo Vouga;95379;28083;5681;0;129143
2019-09-01;Região de Saúde Centro;Centro Hospitalar Tondela-Viseu;83676;23742;12003;0;119421
2019-09-01;Região de Saúde LVT;Centro Hospitalar de Lisboa Ocidental;84867;22883;11865;0;119615
2019-09-01;Região de Saúde LVT;Hospital de Vila Franca de Xira;64873;31418;7835;0;104126
2019-09-01;Região de Saúde Norte;Centro Hospitalar Universitário de São João;125776;54233;11124;0;191133
2019-10-01;Região de Saúde Alentejo;Hospital Espírito Santo de Évora;45702;16352;0;0;62054
2019-10-01;Região de Saúde Alentejo;Unidade Local de Saúde do Litoral Alentejano;78540;0;0;0;78540
2019-10-01;Região de Saúde LVT;Centro Hospitalar Universitário Lisboa Central;118563;61070;17827;5491;202951
2019-10-01;Região de Saúde LVT;Centro Hospitalar do Oeste;102861;37666;9023;0;149550
2019-10-01;Região de Saúde LVT;Hospital de Vila Franca de Xira;72751;36101;8713;0;117565
2019-10-01;Região de Saúde LVT;Hospital Distrital de Santarém;72266;30587;6920;0;109773
2019-10-01;Região de Saúde Norte;Centro Hospitalar Universitário do Porto;108597;0;19406;0;128003
2019-10-01;Região de Saúde Norte;Centro Hospitalar Vila Nova de Gaia/Espinho;108987;33728;10603;0;153318
2019-11-01;Região de Saúde Alentejo;Unidade Local de Saúde do Baixo Alentejo;78657;14427;3808;0;96892
2019-11-01;Região de Saúde Alentejo;Unidade Local de Saúde do Litoral Alentejano;85376;0;0;0;85376
2019-11-01;Região de Saúde LVT;Centro Hospitalar Barreiro/Montijo;99748;34320;10371;0;144439
2019-11-01;Região de Saúde LVT;Centro Hospitalar Universitário Lisboa Central;130020;68632;19518;6029;224199
2019-11-01;Região de Saúde LVT;Centro Hospitalar de Lisboa Ocidental;104425;29315;14385;0;148125
2019-11-01;Região de Saúde LVT;Hospital Distrital de Santarém;79182;33918;7613;0;120713
2019-11-01;Região de Saúde LVT;Hospital Garcia de Orta;95637;38496;16432;0;150565
2019-11-01;Região de Saúde Norte;Hospital Santa Maria Maior;45184;12411;0;0;57595
2019-11-01;Região de Saúde Norte;Unidade Local de Saúde de Matosinhos;72144;0;9779;0;81923
2019-11-01;Região de Saúde Norte;Unidade Local de Saúde do Alto Minho;128428;18210;6177;0;152815
2019-12-01;Região de Saúde Alentejo;Unidade Local de Saúde do Litoral Alentejano;93233;0;0;0;93233
2019-12-01;Região de Saúde Centro;Unidade Local de Saúde da Guarda;80988;15707;3881;0;100576
2019-12-01;Região de Saúde Centro;Unidade Local de Saúde de Castelo Branco;52993;11310;1591;0;65894
2019-12-01;Região de Saúde LVT;Hospital de Vila Franca de Xira;87801;46007;10420;0;144228
2019-12-01;Região de Saúde LVT;Hospital Garcia de Orta;104246;41582;17893;0;163721
2019-12-01;Região de Saúde Norte;Centro Hospitalar do Médio Ave;91935;33638;7454;0;133027
2019-12-01;Região de Saúde Norte;Centro Hospitalar Universitário do Porto;129766;0;23336;0;153102
2019-12-01;Região de Saúde Norte;Centro Hospitalar Trás-os-Montes e Alto Douro;150414;28218;4786;0;183418
2020-01-01;Região de Saúde Alentejo;Unidade Local de Saúde do Baixo Alentejo;8149;1826;403;0;10378
2020-01-01;Região de Saúde Centro;Centro Hospitalar e Universitário de Coimbra;17821;6637;2135;0;26593
2020-01-01;Região de Saúde Centro;Centro Hospitalar Tondela-Viseu;9708;3213;1318;0;14239
2020-01-01;Região de Saúde Centro;Unidade Local de Saúde de Castelo Branco;4571;1130;133;0;5834
2020-01-01;Região de Saúde LVT;Centro Hospitalar de Lisboa Ocidental;10195;3370;1275;0;14840
2020-01-01;Região de Saúde LVT;Centro Hospitalar de Setúbal;7544;3913;1168;0;12625
2020-01-01;Região de Saúde LVT;Centro Hospitalar Médio Tejo;9827;2526;295;0;12648
2020-01-01;Região de Saúde Norte;Centro Hospitalar do Médio Ave;8017;2999;567;0;11583
2020-01-01;Região de Saúde Norte;Centro Hospitalar Tâmega e Sousa;12799;3978;1300;0;18077
2020-01-01;Região de Saúde Norte;Centro Hospitalar Trás-os-Montes e Alto Douro;13219;3105;376;0;16700
2020-02-01;Região de Saúde Alentejo;Hospital Espírito Santo de Évora;8712;3806;0;0;12518
2020-02-01;Região de Saúde Centro;Hospital Distrital da Figueira da Foz;8830;3335;0;0;12165
2020-02-01;Região de Saúde Centro;Unidade Local de Saúde da Guarda;13225;2892;724;0;16841
2020-02-01;Região de Saúde LVT;Hospital de Cascais;15653;9343;2126;0;27122
2020-02-01;Região de Saúde LVT;Hospital Distrital de Santarém;15104;7206;1337;0;23647
2020-02-01;Região de Saúde Norte;Centro Hospitalar Universitário de São João;27233;13792;2404;0;43429
2020-02-01;Região de Saúde Norte;Centro Hospitalar Póvoa de Varzim/Vila do Conde;12664;0;0;0;12664
2020-02-01;Região de Saúde Norte;Centro Hospitalar Trás-os-Montes e Alto Douro;25080;5657;755;0;31492
2020-02-01;Região de Saúde Norte;Unidade Local de Saúde do Alto Minho;23392;4020;1038;0;28450
2020-03-01;Região de Saúde Centro;Centro Hospitalar e Universitário de Coimbra;44594;14969;5768;0;65331
2020-03-01;Região de Saúde Centro;Unidade Local de Saúde de Castelo Branco;11889;2559;324;0;14772
2020-03-01;Região de Saúde LVT;Centro Hospitalar Barreiro/Montijo;25353;9234;2362;0;36949
2020-03-01;Região de Saúde LVT;Centro Hospitalar Universitário de Lisboa Norte;40256;10472;3906;0;54634
2020-03-01;Região de Saúde Norte;Centro Hospitalar Universitário de São João;37784;16989;3103;0;57876
2020-03-01;Região de Saúde Norte;Centro Hospitalar Universitário do Porto;28954;0;5089;0;34043
2020-03-01;Região de Saúde Norte;Centro Hospitalar Póvoa de Varzim/Vila do Conde;16398;0;0;0;16398
2020-04-01;Região de Saúde Alentejo;Unidade Local de Saúde do Norte Alentejano;21197;2331;369;0;23897
2020-04-01;Região de Saúde Centro;Centro Hospitalar e Universitário de Coimbra;52648;16457;7030;0;76135
2020-04-01;Região de Saúde Norte;Centro Hospitalar Entre Douro e Vouga;45968;7628;2446;0;56042
2020-04-01;Região de Saúde Norte;Centro Hospitalar Tâmega e Sousa;42106;9567;4118;0;55791
2020-04-01;Região de Saúde Norte;Centro Hospitalar Trás-os-Montes e Alto Douro;38383;7068;1396;0;46847
2020-05-01;Região de Saúde Alentejo;Hospital Espírito Santo de Évora;17655;5450;0;0;23105
2020-05-01;Região de Saúde Centro;Centro Hospitalar Tondela-Viseu;36133;8991;5371;0;50495
2020-05-01;Região de Saúde LVT;Hospital de Cascais;29479;13443;4485;0;47407
2020-05-01;Região de Saúde LVT;Hospital Distrital de Santarém;28024;9532;2748;0;40304
2020-05-01;Região de Saúde LVT;Hospital Garcia de Orta;35154;8705;6107;0;49966
2020-05-01;Região de Saúde Norte;Unidade Local de Saúde de Matosinhos;28171;0;3428;0;31599
2020-05-01;Região de Saúde Norte;Unidade Local de Saúde do Alto Minho;40821;5367;1956;0;48144
2020-06-01;Região de Saúde Alentejo;Hospital Espírito Santo de Évora;21207;6027;0;0;27234
2020-06-01;Região de Saúde Algarve;Centro Hospitalar Universitário do Algarve;95856;22865;8632;0;127353
2020-06-01;Região de Saúde Centro;Centro Hospitalar Universitário Cova da Beira;19057;4186;1458;0;24701
2020-06-01;Região de Saúde LVT;Centro Hospitalar de Setúbal;35102;12011;5149;0;52262
2020-06-01;Região de Saúde LVT;Hospital de Vila Franca de Xira;35196;14184;4246;0;53626
2020-06-01;Região de Saúde Norte;Centro Hospitalar Trás-os-Montes e Alto Douro;54575;8459;2272;0;65306
2020-06-01;Região de Saúde Norte;Centro Hospitalar Vila Nova de Gaia/Espinho;52296;11742;4937;0;68975
2020-06-01;Região de Saúde Norte;Hospital Santa Maria Maior;19215;4058;0;0;23273
2020-07-01;Região de Saúde Alentejo;Hospital Espírito Santo de Évora;24982;6720;0;0;31702
2020-07-01;Região de Saúde Centro;Centro Hospitalar do Baixo Vouga;56264;11510;3403;0;71177
2020-07-01;Região de Saúde Centro;Unidade Local de Saúde de Castelo Branco;23851;3660;780;0;28291
2020-07-01;Região de Saúde LVT;Centro Hospitalar Universitário de Lisboa Norte;77886;15737;8056;0;101679
2020-07-01;Região de Saúde LVT;Hospital Professor Doutor Fernando Fonseca;80651;18051;9325;0;108027
2020-07-01;Região de Saúde Norte;Hospital da Senhora da Oliveira;44022;9286;4870;0;58178
2020-07-01;Região de Saúde Norte;Hospital de Braga;70524;16579;7190;0;94293
2020-07-01;Região de Saúde Norte;Unidade Local de Saúde do Alto Minho;57040;6426;2758;0;66224
2020-08-01;Região de Saúde Algarve;Centro Hospitalar Universitário do Algarve;134690;29807;11925;0;176422
2020-08-01;Região de Saúde Centro;Centro Hospitalar Tondela-Viseu;60237;12698;8887;0;81822
2020-08-01;Região de Saúde Centro;Hospital Distrital da Figueira da Foz;28772;6837;0;0;35609
2020-08-01;Região de Saúde Centro;Unidade Local de Saúde de Castelo Branco;27480;4050;909;0;32439
2020-08-01;Região de Saúde LVT;Centro Hospitalar de Lisboa Ocidental;56880;11842;7902;0;76624
2020-08-01;Região de Saúde LVT;Centro Hospitalar do Oeste;59622;16118;5261;0;81001
2020-08-01;Região de Saúde LVT;Hospital de Vila Franca de Xira;47171;17144;5640;0;69955
2020-08-01;Região de Saúde LVT;Hospital Distrital de Santarém;43683;12223;4545;0;60451
2020-09-01;Região de Saúde Alentejo;Unidade Local de Saúde do Litoral Alentejano;52491;0;0;0;52491
2020-09-01;Região de Saúde Algarve;Centro Hospitalar Universitário do Algarve;152009;33184;13551;0;198744
2020-09-01;Região de Saúde Centro;Centro Hospitalar Tondela-Viseu;67864;14127;10120;0;92111
2020-09-01;Região de Saúde LVT;Centro Hospitalar do Oeste;66818;17731;5937;0;90486
2020-09-01;Região de Saúde LVT;Hospital de Cascais;53490;21127;8432;0;83049
2020-09-01;Região de Saúde LVT;Hospital de Vila Franca de Xira;52463;18913;6329;0;77705
2020-09-01;Região de Saúde LVT;Hospital Professor Doutor Fernando Fonseca;104292;22355;11976;0;138623
2020-09-01;Região de Saúde Norte;Centro Hospitalar Trás-os-Montes e Alto Douro;84251;11559;4142;0;99952
2020-09-01;Região de Saúde Norte;Unidade Local de Saúde de Matosinhos;51917;0;6160;0;58077
2020-10-01;Região de Saúde Alentejo;Unidade Local de Saúde do Litoral Alentejano;57936;0;0;0;57936
2020-10-01;Região de Saúde Centro;Centro Hospitalar de Leiria;89500;15492;8588;0;113580
2020-10-01;Região de Saúde Centro;Centro Hospitalar do Baixo Vouga;81300;16733;4951;0;102984
2020-10-01;Região de Saúde Centro;Centro Hospitalar Tondela-Viseu;75319;15837;11328;0;102484
2020-10-01;Região de Saúde Centro;Hospital Distrital da Figueira da Foz;35959;8615;0;0;44574
2020-10-01;Região de Saúde Centro;Unidade Local de Saúde da Guarda;49647;7252;3286;0;60185
2020-10-01;Região de Saúde Centro;Unidade Local de Saúde de Castelo Branco;34056;4922;1117;0;40095
2020-10-01;Região de Saúde LVT;Centro Hospitalar de Setúbal;58730;18775;8771;0;86276
2020-10-01;Região de Saúde LVT;Hospital de Vila Franca de Xira;57945;21067;7042;0;86054
2020-10-01;Região de Saúde Norte;Centro Hospitalar Universitário de São João;121179;41681;9282;0;172142
2020-10-01;Região de Saúde Norte;Centro Hospitalar Universitário do Porto;89085;0;17088;0;106173
2020-10-01;Região de Saúde Norte;Centro Hospitalar Póvoa de Varzim/Vila do Conde;44716;0;0;0;44716
2020-10-01;Região de Saúde Norte;Hospital de Braga;103275;23223;10199;0;136697
2020-11-01;Região de Saúde Alentejo;Hospital Espírito Santo de Évora;39510;10059;0;0;49569
2020-11-01;Região de Saúde Alentejo;Unidade Local de Saúde do Litoral Alentejano;62830;0;0;0;62830
2020-11-01;Região de Saúde Centro;Centro Hospitalar de Leiria;96863;16722;9398;0;122983
2020-11-01;Região de Saúde Centro;Unidade Local de Saúde da Guarda;53808;8274;3560;0;65642
2020-11-01;Região de Saúde LVT;Centro Hospitalar Barreiro/Montijo;75732;19410;7548;0;102690
2020-11-01;Região de Saúde LVT;Centro Hospitalar Universitário de Lisboa Norte;122104;24197;12989;0;159290
2020-11-01;Região de Saúde LVT;Centro Hospitalar Médio Tejo;77719;13446;3343;0;94508
2020-12-01;Região de Saúde LVT;Centro Hospitalar Universitário Lisboa Central;101830;47305;17056;5484;171675
2020-12-01;Região de Saúde LVT;Centro Hospitalar Universitário de Lisboa Norte;132360;25952;14059;0;172371
2020-12-01;Região de Saúde Norte;Centro Hospitalar Universitário de São João;144178;49015;10920;0;204113
2020-12-01;Região de Saúde Norte;Centro Hospitalar Tâmega e Sousa;129075;21320;12646;0;163041
2020-12-01;Região de Saúde Norte;Hospital Santa Maria Maior;39546;6046;0;0;45592
2021-01-01;Região de Saúde Centro;Centro Hospitalar Universitário Cova da Beira;2954;379;180;0;3513
2021-01-01;Região de Saúde Centro;Centro Hospitalar de Leiria;7319;1037;688;0;9044
2021-01-01;Região de Saúde Centro;Centro Hospitalar Tondela-Viseu;7156;1009;886;0;9051
2021-01-01;Região de Saúde Centro;Unidade Local de Saúde da Guarda;4309;1088;244;0;5641
2021-01-01;Região de Saúde LVT;Centro Hospitalar Universitário Lisboa Central;7566;3472;1209;334;12581
2021-01-01;Região de Saúde LVT;Centro Hospitalar de Setúbal;5854;1337;665;0;7856
2021-01-01;Região de Saúde LVT;Centro Hospitalar do Oeste;5565;1130;498;0;7193
2021-01-01;Região de Saúde LVT;Hospital Distrital de Santarém;4585;833;436;0;5854
2021-01-01;Região de Saúde LVT;Hospital Garcia de Orta;5730;1190;987;0;7907
2021-01-01;Região de Saúde Norte;Centro Hospitalar do Médio Ave;5754;974;383;0;7111
2021-01-01;Região de Saúde Norte;Centro Hospitalar Entre Douro e Vouga;9385;959;441;0;10785
2021-01-01;Região de Saúde Norte;Centro Hospitalar Vila Nova de Gaia/Espinho;7849;1467;708;0;10024
2021-02-01;Região de Saúde Centro;Centro Hospitalar Universitário Cova da Beira;5341;598;390;0;6329
2021-02-01;Região de Saúde Centro;Centro Hospitalar de Leiria;13232;1666;1325;0;16223
2021-02-01;Região de Saúde Centro;Unidade Local de Saúde de Castelo Branco;5066;518;181;0;5765
2021-02-01;Região de Saúde LVT;Centro Hospitalar de Lisboa Ocidental;10456;1794;1582;0;13832
2021-02-01;Região de Saúde LVT;Centro Hospitalar Universitário de Lisboa Norte;14428;2309;2023;0;18760
2021-02-01;Região de Saúde LVT;Hospital de Loures;10501;2362;1521;0;14384
2021-02-01;Região de Saúde LVT;Hospital Garcia de Orta;10148;1792;1751;0;13691
2021-02-01;Região de Saúde Norte;Centro Hospitalar Trás-os-Montes e Alto Douro;15620;1279;950;0;17849
2021-02-01;Região de Saúde Norte;Hospital da Senhora da Oliveira;10254;1343;1159;0;12756
2021-02-01;Região de Saúde Norte;Unidade Local de Saúde do Alto Minho;12686;825;655;0;14166
2021-03-01;Região de Saúde Alentejo;Unidade Local de Saúde do Baixo Alentejo;12668;1798;782;0;15248
2021-03-01;Região de Saúde Algarve;Centro Hospitalar Universitário do Algarve;39636;5871;4054;0;49561
2021-03-01;Região de Saúde Centro;Unidade Local de Saúde de Castelo Branco;8186;760;298;0;9244
2021-03-01;Região de Saúde LVT;Centro Hospitalar Médio Tejo;17881;2148;676;0;20705
2021-03-01;Região de Saúde LVT;Hospital de Loures;16820;3782;2605;0;23207
2021-03-01;Região de Saúde LVT;Hospital de Vila Franca de Xira;14130;3294;1599;0;19023
2021-03-01;Região de Saúde LVT;Hospital Distrital de Santarém;13004;1874;1408;0;16286
2021-03-01;Região de Saúde Norte;Centro Hospitalar Universitário do Porto;21173;0;3923;0;25096
2021-03-01;Região de Saúde Norte;Centro Hospitalar Trás-os-Montes e Alto Douro;24232;1932;1541;0;27705
2021-03-01;Região de Saúde Norte;Hospital da Senhora da Oliveira;16522;2033;1836;0;20391
2021-03-01;Região de Saúde Norte;Unidade Local de Saúde do Alto Minho;19743;1278;1080;0;22101
2021-04-01;Região de Saúde Alentejo;Unidade Local de Saúde do Norte Alentejano;16089;990;408;0;17487
2021-04-01;Região de Saúde Centro;Centro Hospitalar e Universitário de Coimbra;43851;10098;6192;0;60141
2021-04-01;Região de Saúde Centro;Unidade Local de Saúde da Guarda;16488;2690;1093;0;20271
2021-04-01;Região de Saúde LVT;Hospital Garcia de Orta;22480;4443;4097;0;31020
2021-04-01;Região de Saúde Norte;Centro Hospitalar Entre Douro e Vouga;37499;3512;2144;0;43155
2021-04-01;Região de Saúde Norte;Hospital de Braga;37907;6795;3591;0;48293
2021-04-01;Região de Saúde Norte;Unidade Local de Saúde de Matosinhos;19983;0;2558;0;22541
2021-04-01;Região de Saúde Norte;Unidade Local de Saúde do Nordeste;21917;0;0;0;21917
2021-05-01;Região de Saúde Alentejo;Unidade Local de Saúde do Baixo Alentejo;23587;3529;1367;0;28483
2021-05-01;Região de Saúde Centro;Centro Hospitalar Universitário Cova da Beira;15404;2433;1105;0;18942
2021-05-01;Região de Saúde Centro;Centro Hospitalar do Baixo Vouga;38939;7813;2417;0;49169
2021-05-01;Região de Saúde Centro;Centro Hospitalar e Universitário de Coimbra;58326;14699;7900;0;80925
2021-05-01;Região de Saúde LVT;Centro Hospitalar Barreiro/Montijo;30903;7309;2952;0;41164
2021-05-01;Região de Saúde LVT;Centro Hospitalar de Setúbal;27761;7911;3840;0;39512
2021-05-01;Região de Saúde LVT;Hospital Distrital de Santarém;25152;4978;2588;0;32718
2021-05-01;Região de Saúde LVT;Hospital Garcia de Orta;30108;6924;5347;0;42379
2021-06-01;Região de Saúde Centro;Centro Hospitalar de Leiria;51222;9495;4877;0;65594
2021-06-01;Região de Saúde Centro;Centro Hospitalar e Universitário de Coimbra;72843;19985;9604;0;102432
2021-06-01;Região de Saúde Centro;Hospital Distrital da Figueira da Foz;21013;4802;0;0;25815
2021-06-01;Região de Saúde LVT;Centro Hospitalar Médio Tejo;42079;7378;1578;0;51035
2021-06-01;Região de Saúde Norte;Centro Hospitalar do Médio Ave;35958;8424;2706;0;47088
2021-06-01;Região de Saúde Norte;Centro Hospitalar Universitário do Porto;49880;0;8671;0;58551
2021-06-01;Região de Saúde Norte;Centro Hospitalar Póvoa de Varzim/Vila do Conde;25414;0;0;0;25414
2021-06-01;Região de Saúde Norte;Centro Hospitalar Tâmega e Sousa;61916;11017;5859;0;78792
2021-07-01;Região de Saúde Alentejo;Hospital Espírito Santo de Évora;25424;6525;0;0;31949
2021-07-01;Região de Saúde Algarve;Centro Hospitalar Universitário do Algarve;118211;25134;10531;0;153876
2021-07-01;Região de Saúde Centro;Centro Hospitalar e Universitário de Coimbra;87693;25142;11485;0;124320
2021-07-01;Região de Saúde LVT;Centro Hospitalar do Oeste;50761;14144;4396;0;69301
2021-07-01;Região de Saúde LVT;Hospital de Cascais;39775;18043;6190;0;64008
2021-07-01;Região de Saúde Norte;Centro Hospitalar Universitário do Porto;60764;0;10321;0;71085
2021-07-01;Região de Saúde Norte;Centro Hospitalar Póvoa de Varzim/Vila do Conde;31396;0;0;0;31396
2021-07-01;Região de Saúde Norte;Centro Hospitalar Trás-os-Montes e Alto Douro;67154;8629;3895;0;79678
2021-07-01;Região de Saúde Norte;Centro Hospitalar Vila Nova de Gaia/Espinho;65638;15135;5776;0;86549
2021-07-01;Região de Saúde Norte;Unidade Local de Saúde de Matosinhos;41149;0;5041;0;46190
2021-07-01;Região de Saúde Norte;Unidade Local de Saúde do Alto Minho;57473;5529;2839;0;65841
2021-08-01;Região de Saúde Algarve;Centro Hospitalar Universitário do Algarve;144520;30932;12403;0;187855
2021-08-01;Região de Saúde Centro;Centro Hospitalar Universitário Cova da Beira;27181;5071;1966;0;34218
2021-08-01;Região de Saúde Centro;Centro Hospitalar de Leiria;74564;14513;6853;0;95930
2021-08-01;Região de Saúde Centro;Centro Hospitalar do Baixo Vouga;70760;16587;4090;0;91437
2021-08-01;Região de Saúde Centro;Centro Hospitalar Tondela-Viseu;64018;13400;8814;0;86232
2021-08-01;Região de Saúde Centro;Unidade Local de Saúde de Castelo Branco;26875;5139;877;0;32891
2021-08-01;Região de Saúde LVT;Centro Hospitalar Barreiro/Montijo;54226;14728;5275;0;74229
2021-08-01;Região de Saúde LVT;Centro Hospitalar Universitário Lisboa Central;70850;36619;11446;3664;122579
2021-08-01;Região de Saúde LVT;Centro Hospitalar do Oeste;61122;16794;5130;0;83046
2021-08-01;Região de Saúde Norte;Unidade Local de Saúde de Matosinhos;48179;0;6018;0;54197
2021-09-01;Região de Saúde Algarve;Centro Hospitalar Universitário do Algarve;166246;36196;14162;0;216604
2021-09-01;Região de Saúde Centro;Centro Hospitalar Universitário Cova da Beira;30847;5915;2256;0;39018
2021-09-01;Região de Saúde Centro;Hospital Distrital da Figueira da Foz;34960;8864;0;0;43824
2021-09-01;Região de Saúde Centro;Unidade Local de Saúde da Guarda;45571;7769;2770;0;56110
2021-09-01;Região de Saúde LVT;Centro Hospitalar de Lisboa Ocidental;59279;16146;9110;0;84535
2021-09-01;Região de Saúde LVT;Hospital Professor Doutor Fernando Fonseca;111142;26951;12147;0;150240
2021-09-01;Região de Saúde LVT;Hospital Garcia de Orta;61369;16903;11001;0;89273
2021-09-01;Região de Saúde Norte;Centro Hospitalar do Médio Ave;58147;14324;4336;0;76807
2021-10-01;Região de Saúde Alentejo;Unidade Local de Saúde do Baixo Alentejo;54795;10234;2899;0;67928
2021-10-01;Região de Saúde Centro;Centro Hospitalar Universitário Cova da Beira;34852;7240;2510;0;44602
2021-10-01;Região de Saúde Centro;Centro Hospitalar do Baixo Vouga;91681;23851;5169;0;120701
2021-10-01;Região de Saúde Centro;Centro Hospitalar Tondela-Viseu;82031;18905;11254;0;112190
2021-10-01;Região de Saúde Centro;Unidade Local de Saúde da Guarda;51431;9133;3106;0;63670
2021-10-01;Região de Saúde LVT;Centro Hospitalar de Setúbal;61458;23005;8299;0;92762
2021-10-01;Região de Saúde LVT;Hospital de Loures;70837;29004;11066;0;110907
2021-10-01;Região de Saúde Norte;Centro Hospitalar Tâmega e Sousa;113758;23901;10770;0;148429
2021-10-01;Região de Saúde Norte;Unidade Local de Saúde do Nordeste;70191;0;0;0;70191
2021-11-01;Região de Saúde Centro;Centro Hospitalar Universitário Cova da Beira;38488;8363;2794;422;50067
2021-11-01;Região de Saúde Centro;Hospital Distrital da Figueira da Foz;44182;12371;0;0;56553
2021-11-01;Região de Saúde LVT;Hospital de Loures;77748;33910;12276;0;123934
2021-11-01;Região de Saúde LVT;Hospital Professor Doutor Fernando Fonseca;138564;37703;15170;0;191437
2021-11-01;Região de Saúde LVT;Hospital Garcia de Orta;76471;26021;13843;0;116335
2021-11-01;Região de Saúde Norte;Centro Hospitalar Entre Douro e Vouga;133341;21922;7024;0;162287
2021-12-01;Região de Saúde Centro;Centro Hospitalar de Leiria;117079;24315;10599;0;151993
2021-12-01;Região de Saúde Centro;Hospital Distrital da Figueira da Foz;48212;13659;0;0;61871
2021-12-01;Região de Saúde LVT;Centro Hospitalar do Oeste;97806;32204;7900;0;137910
2021-12-01;Região de Saúde LVT;Centro Hospitalar Médio Tejo;96248;21318;3647;0;121213
2021-12-01;Região de Saúde LVT;Hospital Professor Doutor Fernando Fonseca;152420;42524;16650;0;211594
2021-12-01;Região de Saúde Norte;Centro Hospitalar Trás-os-Montes e Alto Douro;126327;19957;7113;0;153397
2021-12-01;Região de Saúde Norte;Unidade Local de Saúde de Matosinhos;75498;0;9204;0;84702
2022-01-01;Região de Saúde Alentejo;Unidade Local de Saúde do Litoral Alentejano;6742;0;0;0;6742
2022-01-01;Região de Saúde Centro;Centro Hospitalar Tondela-Viseu;8183;1912;1168;0;11263
2022-01-01;Região de Saúde Centro;Unidade Local de Saúde da Guarda;5287;1004;295;0;6586
2022-01-01;Região de Saúde LVT;Centro Hospitalar Universitário Lisboa Central;10523;5100;1514;484;17621
2022-01-01;Região de Saúde LVT;Centro Hospitalar de Setúbal;6684;2621;806;0;10111
2022-01-01;Região de Saúde LVT;Centro Hospitalar Médio Tejo;8366;1716;283;0;10365
2022-01-01;Região de Saúde LVT;Hospital Garcia de Orta;7170;2496;1313;0;10979
2022-01-01;Região de Saúde Norte;Centro Hospitalar do Médio Ave;7397;2012;496;0;9905
2022-01-01;Região de Saúde Norte;Centro Hospitalar Vila Nova de Gaia/Espinho;10332;2717;812;0;13861
2022-01-01;Região de Saúde Norte;Unidade Local de Saúde do Alto Minho;9637;1023;459;0;11119
2022-02-01;Região de Saúde Alentejo;Unidade Local de Saúde do Baixo Alentejo;11788;3328;597;0;15713
2022-02-01;Região de Saúde Alentejo;Unidade Local de Saúde do Norte Alentejano;10244;1266;372;0;11882
2022-02-01;Região de Saúde Centro;Centro Hospitalar de Leiria;19454;3947;1782;0;25183
2022-02-01;Região de Saúde Centro;Centro Hospitalar do Baixo Vouga;18690;5029;942;0;24661
2022-02-01;Região de Saúde LVT;Centro Hospitalar Barreiro/Montijo;15164;5004;1468;0;21636
2022-02-01;Região de Saúde LVT;Centro Hospitalar de Lisboa Ocidental;14802;4968;2296;0;22066
2022-02-01;Região de Saúde LVT;Centro Hospitalar Universitário de Lisboa Norte;22263;5571;2675;0;30509
2022-02-01;Região de Saúde LVT;Hospital Garcia de Orta;13993;5991;2606;0;22590
2022-02-01;Região de Saúde Norte;Centro Hospitalar Universitário do Porto;18607;0;3154;0;21761
2022-02-01;Região de Saúde Norte;Hospital Santa Maria Maior;7758;1586;0;0;9344
2022-03-01;Região de Saúde Alentejo;Unidade Local de Saúde do Baixo Alentejo;18928;5266;923;0;25117
2022-03-01;Região de Saúde Algarve;Centro Hospitalar Universitário do Algarve;59387;16232;4688;0;80307
2022-03-01;Região de Saúde Centro;Centro Hospitalar Universitário Cova da Beira;11296;3158;845;56;15355
2022-03-01;Região de Saúde Centro;Centro Hospitalar de Leiria;31764;8083;2777;0;42624
2022-03-01;Região de Saúde Centro;Centro Hospitalar do Baixo Vouga;29759;9377;1475;0;40611
2022-03-01;Região de Saúde Centro;Hospital Distrital da Figueira da Foz;12331;4473;0;0;16804
2022-03-01;Região de Saúde Norte;Centro Hospitalar Universitário de São João;39673;19430;3093;0;62196
2022-03-01;Região de Saúde Norte;Centro Hospitalar Póvoa de Varzim/Vila do Conde;16996;0;0;0;16996
2022-03-01;Região de Saúde Norte;Centro Hospitalar Trás-os-Montes e Alto Douro;33705;7226;1739;0;42670
2022-04-01;Região de Saúde Alentejo;Hospital Espírito Santo de Évora;17134;6602;0;0;23736
2022-04-01;Região de Saúde Centro;Centro Hospitalar e Universitário de Coimbra;58596;22878;7208;0;88682
2022-04-01;Região de Saúde LVT;Centro Hospitalar de Lisboa Ocidental;31508;12409;4764;0;48681
2022-04-01;Região de Saúde LVT;Hospital de Vila Franca de Xira;25947;15239;2739;0;43925
2022-04-01;Região de Saúde Norte;Centro Hospitalar Universitário de São João;53734;26521;4157;0;84412
2022-04-01;Região de Saúde Norte;Centro Hospitalar Vila Nova de Gaia/Espinho;42127;13883;3058;0;59068
2022-05-01;Região de Saúde Alentejo;Hospital Espírito Santo de Évora;21998;8791;0;0;30789
2022-05-01;Região de Saúde Alentejo;Unidade Local de Saúde do Litoral Alentejano;37492;0;0;0;37492
2022-05-01;Região de Saúde LVT;Centro Hospitalar de Setúbal;35688;19141;4334;0;59163
2022-05-01;Região de Saúde LVT;Hospital de Vila Franca de Xira;33347;19875;3491;0;56713
2022-05-01;Região de Saúde Norte;Centro Hospitalar Póvoa de Varzim/Vila do Conde;30143;0;0;0;30143
2022-05-01;Região de Saúde Norte;Centro Hospitalar Tâmega e Sousa;63715;17199;5803;0;86717
2022-05-01;Região de Saúde Norte;Hospital de Braga;60563;18906;5515;0;84984
2022-06-01;Região de Saúde Alentejo;Unidade Local de Saúde do Litoral Alentejano;45173;0;0;0;45173
2022-06-01;Região de Saúde Alentejo;Unidade Local de Saúde do Norte Alentejano;35211;4432;1120;0;40763
2022-06-01;Região de Saúde Centro;Centro Hospitalar Universitário Cova da Beira;23597;6813;1708;56;32174
2022-06-01;Região de Saúde Centro;Hospital Distrital da Figueira da Foz;25933;9120;0;0;35053
2022-06-01;Região de Saúde LVT;Centro Hospitalar Barreiro/Montijo;51460;19069;4766;0;75295
2022-06-01;Região de Saúde LVT;Centro Hospitalar de Setúbal;42730;22499;5185;0;70414
2022-06-01;Região de Saúde LVT;Centro Hospitalar Universitário de Lisboa Norte;75380;20450;8855;0;104685
2022-06-01;Região de Saúde LVT;Hospital de Loures;47501;26336;6314;0;80151
2022-06-01;Região de Saúde LVT;Hospital de Vila Franca de Xira;40127;23096;4164;0;67387
2022-06-01;Região de Saúde LVT;Hospital Distrital de Santarém;41961;14886;3847;0;60694
2022-06-01;Região de Saúde Norte;Centro Hospitalar Universitário de São João;83483;41237;6336;0;131056
2022-06-01;Região de Saúde Norte;Centro Hospitalar Universitário do Porto;62337;0;10157;0;72494
2022-06-01;Região de Saúde Norte;Hospital da Senhora da Oliveira;50138;16486;4900;0;71524
2022-06-01;Região de Saúde Norte;Hospital de Braga;72430;22154;6503;0;101087
2022-06-01;Região de Saúde Norte;Unidade Local de Saúde do Nordeste;50172;0;0;0;50172
2022-07-01;Região de Saúde Centro;Centro Hospitalar Universitário Cova da Beira;27535;7811;2069;121;37536
2022-07-01;Região de Saúde Centro;Centro Hospitalar do Baixo Vouga;74926;23967;3607;0;102500
2022-07-01;Região de Saúde LVT;Centro Hospitalar Universitário Lisboa Central;78922;47127;11423;3845;141317
2022-07-01;Região de Saúde LVT;Centro Hospitalar de Lisboa Ocidental;56481;20929;8370;0;85780
2022-07-01;Região de Saúde LVT;Centro Hospitalar Universitário de Lisboa Norte;88000;23438;10327;0;121765
2022-07-01;Região de Saúde LVT;Hospital de Cascais;51957;29946;7341;0;89244
2022-07-01;Região de Saúde LVT;Hospital de Loures;55393;30095;7368;0;92856
2022-07-01;Região de Saúde LVT;Hospital Professor Doutor Fernando Fonseca;98468;33593;10998;0;143059
2022-07-01;Região de Saúde Norte;Centro Hospitalar Entre Douro e Vouga;104151;20052;5089;0;129292
2022-07-01;Região de Saúde Norte;Centro Hospitalar Póvoa de Varzim/Vila do Conde;42603;0;0;0;42603
2022-07-01;Região de Saúde Norte;Hospital da Senhora da Oliveira;58672;18964;5906;0;83542
2022-08-01;Região de Saúde Alentejo;Unidade Local de Saúde do Baixo Alentejo;53107;11889;2445;0;67441
2022-08-01;Região de Saúde Alentejo;Unidade Local de Saúde do Litoral Alentejano;61506;0;0;0;61506
2022-08-01;Região de Saúde Alentejo;Unidade Local de Saúde do Norte Alentejano;47424;5488;1552;0;54464
2022-08-01;Região de Saúde Centro;Unidade Local de Saúde da Guarda;50074;9322;2711;0;62107
2022-08-01;Região de Saúde LVT;Centro Hospitalar Barreiro/Montijo;68884;23761;6590;0;99235
2022-08-01;Região de Saúde LVT;Hospital de Cascais;59609;32894;8528;0;101031
2022-08-01;Região de Saúde LVT;Hospital Distrital de Santarém;55625;18999;5164;0;79788
2022-08-01;Região de Saúde LVT;Hospital Garcia de Orta;58705;29384;10585;0;98674
2022-08-01;Região de Saúde Norte;Centro Hospitalar do Médio Ave;60011;19895;4428;0;84334
2022-08-01;Região de Saúde Norte;Centro Hospitalar Universitário do Porto;84214;0;13929;0;98143
2022-08-01;Região de Saúde Norte;Centro Hospitalar Entre Douro e Vouga;119445;22233;5985;0;147663
2022-08-01;Região de Saúde Norte;Centro Hospitalar Póvoa de Varzim/Vila do Conde;48609;0;0;0;48609
2022-08-01;Região de Saúde Norte;Hospital de Braga;97345;28341;8483;0;134169
2022-08-01;Região de Saúde Norte;Hospital Santa Maria Maior;34621;8728;0;0;43349
2022-09-01;Região de Saúde Alentejo;Hospital Espírito Santo de Évora;40247;14465;0;0;54712
2022-09-01;Região de Saúde Alentejo;Unidade Local de Saúde do Baixo Alentejo;59476;13006;2748;0;75230
2022-09-01;Região de Saúde Alentejo;Unidade Local de Saúde do Litoral Alentejano;68847;0;0;0;68847
2022-09-01;Região de Saúde Centro;Centro Hospitalar de Leiria;101562;23469;8928;0;133959
2022-09-01;Região de Saúde Centro;Centro Hospitalar e Universitário de Coimbra;136382;49695;17107;0;203184
2022-09-01;Região de Saúde LVT;Centro Hospitalar Universitário Lisboa Central;101971;57603;15076;5008;179658
2022-09-01;Região de Saúde LVT;Centro Hospitalar de Setúbal;63412;30848;7767;0;102027
2022-09-01;Região de Saúde Norte;Centro Hospitalar Póvoa de Varzim/Vila do Conde;54161;0;0;0;54161
2022-09-01;Região de Saúde Norte;Hospital da Senhora da Oliveira;75570;23276;7798;0;106644
2022-09-01;Região de Saúde Norte;Hospital de Braga;109083;31402;9605;0;150090
2022-10-01;Região de Saúde Alentejo;Hospital Espírito Santo de Évora;45073;16337;0;0;61410
2022-10-01;Região de Saúde Alentejo;Unidade Local de Saúde do Litoral Alentejano;77476;0;0;0;77476
2022-10-01;Região de Saúde Centro;Centro Hospitalar e Universitário de Coimbra;152428;57223;18916;0;228567
2022-10-01;Região de Saúde Norte;Centro Hospitalar Entre Douro e Vouga;150276;28906;7643;0;186825
2022-10-01;Região de Saúde Norte;Hospital da Senhora da Oliveira;84157;27270;8674;0;120101
2022-10-01;Região de Saúde Norte;Unidade Local de Saúde de Matosinhos;70397;0;8053;0;78450
2022-10-01;Região de Saúde Norte;Unidade Local de Saúde do Nordeste;84680;0;0;0;84680
2022-11-01;Região de Saúde Alentejo;Unidade Local de Saúde do Litoral Alentejano;86938;0;0;0;86938
2022-11-01;Região de Saúde Alentejo;Unidade Local de Saúde do Norte Alentejano;65914;7880;2163;0;75957
2022-11-01;Região de Saúde LVT;Centro Hospitalar de Setúbal;77159;40365;9526;0;127050
2022-11-01;Região de Saúde Norte;Centro Hospitalar do Médio Ave;82234;29743;6125;0;118102
2022-11-01;Região de Saúde Norte;Hospital Santa Maria Maior;48180;13083;0;0;61263
2022-12-01;Região de Saúde Alentejo;Unidade Local de Saúde do Baixo Alentejo;82768;18840;3654;0;105262
2022-12-01;Região de Saúde Algarve;Centro Hospitalar Universitário do Algarve;280780;73139;20009;0;373928
2022-12-01;Região de Saúde Centro;Centro Hospitalar Universitário Cova da Beira;48182;14592;3769;466;67009
2022-12-01;Região de Saúde LVT;Centro Hospitalar Universitário de Lisboa Norte;147546;42134;17464;0;207144
2022-12-01;Região de Saúde LVT;Hospital de Vila Franca de Xira;80236;48086;8551;0;136873
2022-12-01;Região de Saúde Norte;Centro Hospitalar Universitário de São João;168897;84352;12438;0;265687
2022-12-01;Região de Saúde Norte;Unidade Local de Saúde do Alto Minho;137374;20240;6131;0;163745
2023-01-01;Região de Saúde LVT;Centro Hospitalar de Setúbal;6350;3210;808;0;10368
2023-01-01;Região de Saúde LVT;Centro Hospitalar do Oeste;9167;4150;574;0;13891
2023-01-01;Região de Saúde Norte;Centro Hospitalar Vila Nova de Gaia/Espinho;11163;3623;636;0;15422
2023-02-01;Região de Saúde Centro;Centro Hospitalar de Leiria;20440;5356;1984;0;27780
2023-02-01;Região de Saúde LVT;Centro Hospitalar Universitário Lisboa Central;21498;13587;3330;922;39337
2023-02-01;Região de Saúde LVT;Centro Hospitalar de Lisboa Ocidental;14966;5694;2077;0;22737
2023-02-01;Região de Saúde LVT;Centro Hospitalar de Setúbal;12275;6211;1475;0;19961
2023-02-01;Região de Saúde LVT;Hospital de Cascais;14284;8090;2070;0;24444
2023-02-01;Região de Saúde LVT;Hospital Garcia de Orta;13225;8029;2957;0;24211
2023-02-01;Região de Saúde Norte;Centro Hospitalar Vila Nova de Gaia/Espinho;21508;7099;1251;0;29858
2023-03-01;Região de Saúde Alentejo;Unidade Local de Saúde do Litoral Alentejano;24069;0;0;0;24069
2023-03-01;Região de Saúde LVT;Centro Hospitalar Universitário Lisboa Central;32966;21037;5255;1428;60686
2023-03-01;Região de Saúde LVT;Centro Hospitalar de Setúbal;18882;9435;2262;0;30579
2023-03-01;Região de Saúde LVT;Hospital Professor Doutor Fernando Fonseca;43487;15579;4829;0;63895
2023-03-01;Região de Saúde Norte;Hospital da Senhora da Oliveira;25624;9156;2489;0;37269
2023-03-01;Região de Saúde Norte;Unidade Local de Saúde de Matosinhos;19775;0;2314;0;22089
2023-03-01;Região de Saúde Norte;Unidade Local de Saúde do Alto Minho;34670;5760;1541;0;41971
2023-04-01;Região de Saúde Centro;Centro Hospitalar Universitário Cova da Beira;16168;5131;1298;86;22683
2023-04-01;Região de Saúde Centro;Centro Hospitalar de Leiria;42485;10969;4187;0;57641
2023-04-01;Região de Saúde Centro;Hospital Distrital da Figueira da Foz;16569;6385;0;0;22954
2023-04-01;Região de Saúde LVT;Hospital de Loures;26780;13852;4351;0;44983
2023-04-01;Região de Saúde Norte;Centro Hospitalar Universitário de São João;57087;26512;4102;0;87701
2023-04-01;Região de Saúde Norte;Centro Hospitalar Póvoa de Varzim/Vila do Conde;23617;0;0;0;23617
2023-04-01;Região de Saúde Norte;Unidade Local de Saúde do Alto Minho;45859;7247;2077;0;55183
2023-05-01;Região de Saúde Alentejo;Hospital Espírito Santo de Évora;21398;7719;0;0;29117
2023-05-01;Região de Saúde Alentejo;Unidade Local de Saúde do Baixo Alentejo;37808;7371;1654;0;46833
2023-05-01;Região de Saúde Centro;Hospital Distrital da Figueira da Foz;21052;8236;0;0;29288
2023-05-01;Região de Saúde LVT;Hospital de Vila Franca de Xira;33648;20548;3423;0;57619
2023-05-01;Região de Saúde LVT;Hospital Garcia de Orta;34794;20886;7634;0;63314
2023-05-01;Região de Saúde Norte;Centro Hospitalar Entre Douro e Vouga;77232;15269;3551;0;96052
2023-05-01;Região de Saúde Norte;Centro Hospitalar Póvoa de Varzim/Vila do Conde;29916;0;0;0;29916
2023-05-01;Região de Saúde Norte;Centro Hospitalar Trás-os-Montes e Alto Douro;62297;13304;3369;0;78970
2023-05-01;Região de Saúde Norte;Unidade Local de Saúde do Nordeste;41134;0;0;0;41134
2023-06-01;Região de Saúde Alentejo;Hospital Espírito Santo de Évora;25827;9085;0;0;34912
2023-06-01;Região de Saúde Alentejo;Unidade Local de Saúde do Litoral Alentejano;47964;0;0;0;47964
2023-06-01;Região de Saúde Algarve;Centro Hospitalar Universitário do Algarve;138876;34908;9528;0;183312
2023-06-01;Região de Saúde Centro;Centro Hospitalar do Baixo Vouga;65790;21991;3427;0;91208
2023-06-01;Região de Saúde Centro;Hospital Distrital da Figueira da Foz;25454;9747;0;0;35201
2023-06-01;Região de Saúde LVT;Centro Hospitalar Barreiro/Montijo;56827;20074;4628;0;81529
2023-06-01;Região de Saúde LVT;Centro Hospitalar Médio Tejo;58399;17998;2177;0;78574
2023-06-01;Região de Saúde Norte;Hospital Santa Maria Maior;26749;6597;0;0;33346
2023-07-01;Região de Saúde Alentejo;Unidade Local de Saúde do Baixo Alentejo;53024;10371;2345;0;65740
2023-07-01;Região de Saúde Algarve;Centro Hospitalar Universitário do Algarve;166494;40638;11033;0;218165
2023-07-01;Região de Saúde Centro;Centro Hospitalar Universitário Cova da Beira;28856;8612;2315;234;40017
2023-07-01;Região de Saúde LVT;Centro Hospitalar Barreiro/Montijo;66662;22173;5373;0;94208
2023-07-01;Região de Saúde LVT;Centro Hospitalar Universitário de Lisboa Norte;82528;27117;10318;0;119963
2023-07-01;Região de Saúde LVT;Centro Hospitalar Médio Tejo;68899;19841;2609;0;91349
2023-07-01;Região de Saúde LVT;Hospital de Loures;47743;20569;7724;0;76036
2023-07-01;Região de Saúde LVT;Hospital de Vila Franca de Xira;47429;27131;4978;0;79538
2023-07-01;Região de Saúde Norte;Centro Hospitalar do Médio Ave;51425;18835;4078;0;74338
2023-08-01;Região de Saúde Algarve;Centro Hospitalar Universitário do Algarve;196405;46622;12738;0;255765
2023-08-01;Região de Saúde Centro;Centro Hospitalar do Baixo Vouga;90042;28046;4706;0;122794
2023-08-01;Região de Saúde Centro;Hospital Distrital da Figueira da Foz;35780;12724;0;0;48504
2023-08-01;Região de Saúde LVT;Centro Hospitalar do Oeste;79972;30541;3029;0;113542
2023-08-01;Região de Saúde Norte;Centro Hospitalar Entre Douro e Vouga;125411;22806;5889;0;154106
2023-08-01;Região de Saúde Norte;Centro Hospitalar Vila Nova de Gaia/Espinho;94585;29283;5648;0;129516
2023-08-01;Região de Saúde Norte;Hospital de Braga;102780;30838;9082;0;142700
2023-09-01;Região de Saúde Alentejo;Unidade Local de Saúde do Baixo Alentejo;67704;12724;3051;0;83479
2023-09-01;Região de Saúde LVT;Hospital Distrital de Santarém;62275;22586;5767;0;90628
2023-09-01;Região de Saúde Norte;Hospital da Senhora da Oliveira;77541;24200;8112;0;109853
2023-09-01;Região de Saúde Norte;Unidade Local de Saúde de Matosinhos;63356;0;7191;0;70547
2023-10-01;Região de Saúde Alentejo;Hospital Espírito Santo de Évora;43618;14266;0;0;57884
2023-10-01;Região de Saúde Alentejo;Unidade Local de Saúde do Norte Alentejano;65211;6688;2106;0;74005
2023-10-01;Região de Saúde Centro;Centro Hospitalar do Baixo Vouga;111601;34663;5916;0;152180
2023-10-01;Região de Saúde Centro;Centro Hospitalar Tondela-Viseu;95973;27991;12656;0;136620
2023-10-01;Região de Saúde Centro;Hospital Distrital da Figueira da Foz;44166;15625;0;0;59791
2023-10-01;Região de Saúde LVT;Hospital Distrital de Santarém;68168;25654;6441;0;100263
2023-10-01;Região de Saúde Norte;Centro Hospitalar Vila Nova de Gaia/Espinho;118588;37094;7099;0;162781
2023-11-01;Região de Saúde Centro;Hospital Distrital da Figueira da Foz;47856;17460;0;0;65316
2023-11-01;Região de Saúde Centro;Unidade Local de Saúde da Guarda;71885;13464;3877;0;89226
2023-11-01;Região de Saúde LVT;Centro Hospitalar de Setúbal;68894;30546;9018;0;108458
2023-11-01;Região de Saúde Norte;Centro Hospitalar Vila Nova de Gaia/Espinho;129134;42396;7869;0;179399
2023-11-01;Região de Saúde Norte;Hospital da Senhora da Oliveira;95799;31952;10261;0;138012
2023-12-01;Região de Saúde Alentejo;Hospital Espírito Santo de Évora;50860;17123;0;0;67983
2023-12-01;Região de Saúde Alentejo;Unidade Local de Saúde do Baixo Alentejo;90385;18106;4201;0;112692
2023-12-01;Região de Saúde Alentejo;Unidade Local de Saúde do Norte Alentejano;78462;8562;2534;0;89558
2023-12-01;Região de Saúde Algarve;Centro Hospitalar Universitário do Algarve;287985;71406;18299;0;377690
2023-12-01;Região de Saúde Centro;Centro Hospitalar de Leiria;131170;31298;13104;0;175572
2023-12-01;Região de Saúde LVT;Centro Hospitalar Barreiro/Montijo;114983;32852;9064;0;156899
2023-12-01;Região de Saúde LVT;Centro Hospitalar do Oeste;118679;47109;3822;0;169610
2023-12-01;Região de Saúde LVT;Hospital de Loures;78126;30998;13937;0;123061
2023-12-01;Região de Saúde Norte;Centro Hospitalar Universitário de São João;173776;80558;13333;0;267667
2023-12-01;Região de Saúde Norte;Centro Hospitalar do Médio Ave;87348;32842;7247;0;127437
2019-01-01;Região de Saúde Alentejo;Unidade Local de Saúde do Litoral Alentejano;8492;0;0;0;8492
2019-01-01;Região de Saúde Centro;Unidade Local de Saúde da Guarda;7485;1631;305;0;9421
2019-01-01;Região de Saúde LVT;Centro Hospitalar de Setúbal;7579;4091;1087;0;12757
2019-01-01;Região de Saúde LVT;Centro Hospitalar do Oeste;10776;5195;836;0;16807
2019-01-01;Região de Saúde LVT;Hospital de Vila Franca de Xira;7700;4538;821;0;13059
2019-01-01;Região de Saúde LVT;Hospital Garcia de Orta;8857;4705;1501;0;15063
2019-01-01;Região de Saúde Norte;Centro Hospitalar Trás-os-Montes e Alto Douro;12701;2911;371;0;15983
2019-02-01;Região de Saúde Alentejo;Unidade Local de Saúde do Baixo Alentejo;15873;3560;537;0;19970
2019-02-01;Região de Saúde Alentejo;Unidade Local de Saúde do Norte Alentejano;14079;1548;235;0;15862
2019-02-01;Região de Saúde Centro;Centro Hospitalar Tondela-Viseu;17716;6328;2415;0;26459
2019-02-01;Região de Saúde LVT;Centro Hospitalar Barreiro/Montijo;18008;6968;1683;0;26659
2019-02-01;Região de Saúde LVT;Centro Hospitalar de Lisboa Ocidental;18803;6154;2520;0;27477
2019-02-01;Região de Saúde LVT;Hospital de Cascais;14861;9674;2295;0;26830
2019-02-01;Região de Saúde LVT;Hospital de Vila Franca de Xira;14472;8535;1554;0;24561
2019-02-01;Região de Saúde Norte;Centro Hospitalar Vila Nova de Gaia/Espinho;20803;8250;2008;0;31061
2019-02-01;Região de Saúde Norte;Hospital de Braga;25143;9391;2717;0;37251
2019-02-01;Região de Saúde Norte;Hospital Santa Maria Maior;8122;2863;0;0;10985
2019-02-01;Região de Saúde Norte;Unidade Local de Saúde do Alto Minho;23061;4231;1013;0;28305
2019-02-01;Região de Saúde Norte;Unidade Local de Saúde do Nordeste;19853;0;0;0;19853
2019-03-01;Região de Saúde Alentejo;Hospital Espírito Santo de Évora;13475;5556;0;0;19031
2019-03-01;Região de Saúde Alentejo;Unidade Local de Saúde do Baixo Alentejo;22874;5013;764;0;28651
2019-03-01;Região de Saúde Centro;Centro Hospitalar do Baixo Vouga;31087;10847;1660;0;43594
2019-03-01;Região de Saúde LVT;Hospital de Loures;29943;16577;4331;0;50851
2019-03-01;Região de Saúde Norte;Centro Hospitalar Entre Douro e Vouga;43354;8910;2242;0;54506
2019-03-01;Região de Saúde Norte;Centro Hospitalar Tâmega e Sousa;34977;10608;3417;0;49002
2019-03-01;Região de Saúde Norte;Unidade Local de Saúde do Alto Minho;34482;5920;1566;0;41968
2019-04-01;Região de Saúde Alentejo;Unidade Local de Saúde do Baixo Alentejo;29455;6183;1066;0;36704
2019-04-01;Região de Saúde Alentejo;Unidade Local de Saúde do Litoral Alentejano;30849;0;0;0;30849
2019-04-01;Região de Saúde Algarve;Centro Hospitalar Universitário do Algarve;82474;25852;6786;0;115112
2019-04-01;Região de Saúde Centro;Centro Hospitalar Universitário Cova da Beira;16892;5802;1143;0;23837
2019-04-01;Região de Saúde Centro;Unidade Local de Saúde da Guarda;22919;4682;1053;0;28654
2019-04-01;Região de Saúde LVT;Centro Hospitalar Barreiro/Montijo;35471;12977;3507;0;51955
2019-04-01;Região de Saúde LVT;Centro Hospitalar do Oeste;39576;16664;3324;0;59564
2019-04-01;Região de Saúde LVT;Centro Hospitalar Universitário de Lisboa Norte;60133;15380;5978;0;81491
2019-04-01;Região de Saúde LVT;Hospital de Cascais;30009;18298;4705;0;53012
2019-04-01;Região de Saúde Norte;Centro Hospitalar Universitário do Porto;41948;0;7078;0;49026
2019-04-01;Região de Saúde Norte;Hospital da Senhora da Oliveira;32419;10958;3169;0;46546
2019-05-01;Região de Saúde Alentejo;Hospital Espírito Santo de Évora;22559;8953;0;0;31512
2019-05-01;Região de Saúde Centro;Centro Hospitalar Tondela-Viseu;45294;14321;6391;0;66006
2019-05-01;Região de Saúde Centro;Unidade Local de Saúde da Guarda;33750;6788;1611;0;42149
2019-05-01;Região de Saúde LVT;Centro Hospitalar Barreiro/Montijo;44958;16436;4454;0;65848
2019-05-01;Região de Saúde LVT;Centro Hospitalar Universitário de Lisboa Norte;76536;19345;7618;0;103499
2019-05-01;Região de Saúde LVT;Hospital Garcia de Orta;42552;19148;7178;0;68878
2019-05-01;Região de Saúde Norte;Centro Hospitalar Póvoa de Varzim/Vila do Conde;30493;0;0;0;30493
2019-05-01;Região de Saúde Norte;Hospital de Braga;63906;21590;6794;0;92290
2019-05-01;Região de Saúde Norte;Hospital Santa Maria Maior;20427;6169;0;0;26596
2019-05-01;Região de Saúde Norte;Unidade Local de Saúde de Matosinhos;32572;0;4330;0;36902
2019-06-01;Região de Saúde Centro;Centro Hospitalar Universitário Cova da Beira;25340;8350;1716;0;35406
2019-06-01;Região de Saúde Centro;Centro Hospitalar e Universitário de Coimbra;103512;33081;12144;0;148737
2019-06-01;Região de Saúde LVT;Centro Hospitalar de Lisboa Ocidental;56390;16612;7704;0;80706
2019-06-01;Região de Saúde Norte;Centro Hospitalar Universitário de São João;82266;38485;7204;0;127955
2019-07-01;Região de Saúde Alentejo;Unidade Local de Saúde do Litoral Alentejano;54111;0;0;0;54111
2019-07-01;Região de Saúde Centro;Hospital Distrital da Figueira da Foz;31462;11000;0;0;42462
2019-07-01;Região de Saúde LVT;Centro Hospitalar do Oeste;70130;26988;6016;0;103134
2019-07-01;Região de Saúde LVT;Hospital de Cascais;53227;30552;8487;0;92266
2019-07-01;Região de Saúde LVT;Hospital de Loures;70326;34956;10518;0;115800
2019-07-01;Região de Saúde LVT;Hospital de Vila Franca de Xira;50120;25648;5923;0;81691
2019-07-01;Região de Saúde LVT;Hospital Professor Doutor Fernando Fonseca;104889;32968;12434;0;150291
2019-07-01;Região de Saúde Norte;Centro Hospitalar Vila Nova de Gaia/Espinho;75393;24209;7279;0;106881
2019-08-01;Região de Saúde Algarve;Centro Hospitalar Universitário do Algarve;179590;49053;14557;0;243200
2019-08-01;Região de Saúde Centro;Centro Hospitalar Tondela-Viseu;74394;21424;10563;0;106381
2019-08-01;Região de Saúde LVT;Centro Hospitalar de Setúbal;61551;25989;9224;0;96764
2019-08-01;Região de Saúde LVT;Hospital Professor Doutor Fernando Fonseca;119738;36380;14358;0;170476
2019-08-01;Região de Saúde Norte;Centro Hospitalar Vila Nova de Gaia/Espinho;86581;26586;8393;0;121560
2019-08-01;Região de Saúde Norte;Hospital da Senhora da Oliveira;66072;19248;6835;0;92155
2019-08-01;Região de Saúde Norte;Hospital de Braga;104621;31895;11296;0;147812
2019-08-01;Região de Saúde Norte;Unidade Local de Saúde do Alto Minho;93483;12991;4435;0;110909
2019-09-01;Região de Saúde Alentejo;Hospital Espírito Santo de Évora;40911;14508;0;0;55419
2019-09-01;Região de Saúde Centro;Centro Hospitalar Universitário Cova da Beira;38439;11448;2745;0;52632
2019-09-01;Região de Saúde Centro;Hospital Distrital da Figueira da Foz;41463;13628;0;0;55091
2019-09-01;Região de Saúde Centro;Unidade Local de Saúde da Guarda;61104;11097;2905;0;75106
2019-09-01;Região de Saúde Centro;Unidade Local de Saúde de Castelo Branco;39432;7788;1237;0;48457
2019-09-01;Região de Saúde LVT;Centro Hospitalar Universitário Lisboa Central;105942;53588;16051;4871;180452
2019-09-01;Região de Saúde LVT;Centro Hospitalar Universitário de Lisboa Norte;139117;32426;14216;0;185759
2019-09-01;Região de Saúde LVT;Hospital Professor Doutor Fernando Fonseca;134913;40827;16354;0;192094
2019-09-01;Região de Saúde Norte;Centro Hospitalar do Médio Ave;69030;23571;5607;0;98208
2019-09-01;Região de Saúde Norte;Centro Hospitalar Tâmega e Sousa;107344;25314;11174;0;143832
2019-09-01;Região de Saúde Norte;Hospital de Braga;117499;35300;12815;0;165614
2019-10-01;Região de Saúde Alentejo;Unidade Local de Saúde do Norte Alentejano;67812;6760;1098;0;75670
2019-10-01;Região de Saúde Centro;Centro Hospitalar do Baixo Vouga;106647;31941;6393;0;144981
2019-10-01;Região de Saúde Centro;Hospital Distrital da Figueira da Foz;45972;15359;0;0;61331
2019-10-01;Região de Saúde Norte;Centro Hospitalar Trás-os-Montes e Alto Douro;125968;22569;3982;0;152519
2019-11-01;Região de Saúde Alentejo;Hospital Espírito Santo de Évora;50046;18011;0;0;68057
2019-11-01;Região de Saúde Centro;Centro Hospitalar de Leiria;129344;30876;12022;0;172242
2019-11-01;Região de Saúde Centro;Centro Hospitalar e Universitário de Coimbra;191987;58688;22992;0;273667
2019-11-01;Região de Saúde Centro;Centro Hospitalar Tondela-Viseu;102573;29957;14606;0;147136
2019-11-01;Região de Saúde Centro;Unidade Local de Saúde de Castelo Branco;48528;10101;1473;0;60102
2019-11-01;Região de Saúde LVT;Centro Hospitalar do Oeste;112619;42397;9894;0;164910
2019-11-01;Região de Saúde LVT;Centro Hospitalar Médio Tejo;107410;25337;2815;0;135562
2019-11-01;Região de Saúde LVT;Hospital de Cascais;84869;47821;13640;0;146330
2019-11-01;Região de Saúde Norte;Centro Hospitalar Póvoa de Varzim/Vila do Conde;66407;0;0;0;66407
2019-11-01;Região de Saúde Norte;Centro Hospitalar Tâmega e Sousa;130979;32623;13652;0;177254
2019-12-01;Região de Saúde Alentejo;Hospital Espírito Santo de Évora;54535;19979;0;0;74514
2019-12-01;Região de Saúde Alentejo;Unidade Local de Saúde do Baixo Alentejo;85980;15979;4197;0;106156
2019-12-01;Região de Saúde Centro;Centro Hospitalar de Leiria;141412;35093;13048;0;189553
2019-12-01;Região de Saúde Centro;Centro Hospitalar e Universitário de Coimbra;208407;65376;25256;0;299039
2019-12-01;Região de Saúde LVT;Centro Hospitalar do Oeste;123120;48732;10774;0;182626
2019-12-01;Região de Saúde LVT;Centro Hospitalar Universitário de Lisboa Norte;186423;46345;18923;0;251691
2019-12-01;Região de Saúde Norte;Hospital de Braga;156305;50284;17055;0;223644
2020-01-01;Região de Saúde Alentejo;Unidade Local de Saúde do Litoral Alentejano;8395;0;0;0;8395
2020-01-01;Região de Saúde Centro;Centro Hospitalar de Leiria;11985;2989;1096;0;16070
2020-01-01;Região de Saúde LVT;Centro Hospitalar Universitário de Lisboa Norte;16322;4612;1614;0;22548
2020-01-01;Região de Saúde LVT;Hospital Distrital de Santarém;7890;3852;676;0;12418
2020-01-01;Região de Saúde Norte;Centro Hospitalar Universitário de São João;14302;7339;1271;0;22912
2020-01-01;Região de Saúde Norte;Centro Hospitalar Universitário do Porto;11147;0;1921;0;13068
2020-02-01;Região de Saúde Alentejo;Unidade Local de Saúde do Baixo Alentejo;15461;3383;763;0;19607
2020-02-01;Região de Saúde Alentejo;Unidade Local de Saúde do Litoral Alentejano;16505;0;0;0;16505
2020-02-01;Região de Saúde Centro;Centro Hospitalar do Baixo Vouga;21207;7175;1192;0;29574
2020-02-01;Região de Saúde Centro;Centro Hospitalar e Universitário de Coimbra;33983;12301;4083;0;50367
2020-02-01;Região de Saúde LVT;Centro Hospitalar Barreiro/Montijo;19085;7614;1788;0;28487
2020-02-01;Região de Saúde LVT;Centro Hospitalar de Lisboa Ocidental;19621;6451;2435;0;28507
2020-02-01;Região de Saúde LVT;Centro Hospitalar Médio Tejo;19127;5149;563;0;24839
2020-02-01;Região de Saúde LVT;Hospital Garcia de Orta;17731;5958;3097;0;26786
2020-02-01;Região de Saúde Norte;Hospital da Senhora da Oliveira;16202;5546;1708;0;23456
2020-02-01;Região de Saúde Norte;Hospital Santa Maria Maior;8338;2977;0;0;11315
2020-03-01;Região de Saúde Alentejo;Unidade Local de Saúde do Litoral Alentejano;21569;0;0;0;21569
2020-03-01;Região de Saúde Centro;Centro Hospitalar Universitário Cova da Beira;10921;3323;796;0;15040
2020-03-01;Região de Saúde Centro;Centro Hospitalar do Baixo Vouga;28370;8329;1592;0;38291
2020-03-01;Região de Saúde LVT;Centro Hospitalar de Lisboa Ocidental;25797;7701;3290;0;36788
2020-03-01;Região de Saúde LVT;Hospital de Loures;26203;13492;4149;0;43844
2020-03-01;Região de Saúde LVT;Hospital Professor Doutor Fernando Fonseca;40361;13160;4734;0;58255
2020-03-01;Região de Saúde Norte;Centro Hospitalar Trás-os-Montes e Alto Douro;32751;6655;1072;0;40478
2020-03-01;Região de Saúde Norte;Hospital da Senhora da Oliveira;21536;6611;2293;0;30440
2020-03-01;Região de Saúde Norte;Unidade Local de Saúde do Alto Minho;30173;4674;1366;0;36213
2020-04-01;Região de Saúde Alentejo;Unidade Local de Saúde do Baixo Alentejo;23579;4227;1322;0;29128
2020-04-01;Região de Saúde Centro;Centro Hospitalar do Baixo Vouga;33706;8661;1966;0;44333
2020-04-01;Região de Saúde LVT;Centro Hospitalar Universitário de Lisboa Norte;47296;11351;4681;0;63328
2020-04-01;Região de Saúde Norte;Unidade Local de Saúde de Matosinhos;23152;0;2918;0;26070
2020-05-01;Região de Saúde Alentejo;Unidade Local de Saúde do Litoral Alentejano;29349;0;0;0;29349
2020-05-01;Região de Saúde Centro;Centro Hospitalar de Leiria;44973;8679;4245;0;57897
2020-05-01;Região de Saúde LVT;Centro Hospitalar Barreiro/Montijo;35905;10810;3472;0;50187
2020-05-01;Região de Saúde LVT;Centro Hospitalar Médio Tejo;36036;7368;1444;0;44848
2020-05-01;Região de Saúde LVT;Hospital Professor Doutor Fernando Fonseca;59039;15237;6978;0;81254
2020-05-01;Região de Saúde Norte;Centro Hospitalar do Médio Ave;30311;8407;2266;0;40984
2020-05-01;Região de Saúde Norte;Hospital de Braga;48797;12927;5215;0;66939
2020-05-01;Região de Saúde Norte;Hospital Santa Maria Maior;16091;3844;0;0;19935
2020-06-01;Região de Saúde Centro;Centro Hospitalar e Universitário de Coimbra;75427;20918;10172;0;106517
2020-06-01;Região de Saúde Centro;Centro Hospitalar Tondela-Viseu;43347;10014;6520;0;59881
2020-06-01;Região de Saúde LVT;Centro Hospitalar Universitário Lisboa Central;52046;25340;8605;2649;88640
2020-06-01;Região de Saúde LVT;Centro Hospitalar do Oeste;44694;13488;3892;0;62074
2020-06-01;Região de Saúde LVT;Centro Hospitalar Médio Tejo;42602;8060;1802;0;52464
2020-06-01;Região de Saúde Norte;Centro Hospitalar Universitário do Porto;53265;0;9995;0;63260
2020-06-01;Região de Saúde Norte;Centro Hospitalar Entre Douro e Vouga;64110;9065;3389;0;76564
2020-06-01;Região de Saúde Norte;Unidade Local de Saúde do Nordeste;40162;0;0;0;40162
2020-07-01;Região de Saúde Alentejo;Unidade Local de Saúde do Norte Alentejano;34700;3156;790;0;38646
2020-07-01;Região de Saúde Centro;Centro Hospitalar Universitário Cova da Beira;22396;4644;1690;0;28730
2020-07-01;Região de Saúde Centro;Hospital Distrital da Figueira da Foz;24341;6016;0;0;30357
2020-07-01;Região de Saúde LVT;Centro Hospitalar Barreiro/Montijo;49232;13010;4787;0;67029
2020-07-01;Região de Saúde LVT;Centro Hospitalar Médio Tejo;50119;9039;2141;0;61299
2020-07-01;Região de Saúde LVT;Hospital de Loures;51814;18612;7688;0;78114
2020-07-01;Região de Saúde Norte;Centro Hospitalar Entre Douro e Vouga;75132;10043;3991;0;89166
2020-07-01;Região de Saúde Norte;Centro Hospitalar Póvoa de Varzim/Vila do Conde;31281;0;0;0;31281
2020-07-01;Região de Saúde Norte;Centro Hospitalar Trás-os-Montes e Alto Douro;64502;9433;2871;0;76806
2020-07-01;Região de Saúde Norte;Centro Hospitalar Vila Nova de Gaia/Espinho;62122;13286;5858;0;81266
2020-08-01;Região de Saúde Alentejo;Hospital Espírito Santo de Évora;28822;7534;0;0;36356
2020-08-01;Região de Saúde Alentejo;Unidade Local de Saúde do Baixo Alentejo;42561;6067;2321;0;50949
2020-08-01;Região de Saúde Centro;Centro Hospitalar do Baixo Vouga;64791;12884;3939;0;81614
2020-08-01;Região de Saúde Centro;Centro Hospitalar e Universitário de Coimbra;102697;26831;13901;0;143429
2020-08-01;Região de Saúde Centro;Unidade Local de Saúde da Guarda;37627;5844;2678;0;46149
2020-08-01;Região de Saúde LVT;Hospital de Loures;58725;20185;8857;0;87767
2020-08-01;Região de Saúde LVT;Hospital Professor Doutor Fernando Fonseca;92408;19806;10749;0;122963
2020-08-01;Região de Saúde Norte;Centro Hospitalar do Médio Ave;49332;11612;3813;0;64757
2020-08-01;Região de Saúde Norte;Centro Hospitalar Póvoa de Varzim/Vila do Conde;35771;0;0;0;35771
2020-08-01;Região de Saúde Norte;Centro Hospitalar Trás-os-Montes e Alto Douro;75143;10501;3519;0;89163
2020-08-01;Região de Saúde Norte;Centro Hospitalar Vila Nova de Gaia/Espinho;71538;14714;6821;0;93073
2020-08-01;Região de Saúde Norte;Hospital da Senhora da Oliveira;50754;10189;5664;0;66607
2020-08-01;Região de Saúde Norte;Unidade Local de Saúde de Matosinhos;45777;0;5465;0;51242
2020-08-01;Região de Saúde Norte;Unidade Local de Saúde do Alto Minho;66147;7110;3294;0;76551
2020-09-01;Região de Saúde Alentejo;Hospital Espírito Santo de Évora;32546;8361;0;0;40907
2020-09-01;Região de Saúde Centro;Centro Hospitalar de Leiria;80957;13876;7735;0;102568
2020-09-01;Região de Saúde Centro;Centro Hospitalar e Universitário de Coimbra;115596;30094;15710;0;161400
2020-09-01;Região de Saúde Centro;Hospital Distrital da Figueira da Foz;32518;7682;0;0;40200
2020-09-01;Região de Saúde Centro;Unidade Local de Saúde de Castelo Branco;30814;4466;1011;0;36291
2020-09-01;Região de Saúde LVT;Centro Hospitalar Universitário Lisboa Central;77523;35588;13046;4197;130354
2020-09-01;Região de Saúde LVT;Centro Hospitalar Universitário de Lisboa Norte;100368;19644;10620;0;130632
2020-09-01;Região de Saúde LVT;Centro Hospitalar Médio Tejo;64847;11172;2751;0;78770
2020-09-01;Região de Saúde LVT;Hospital Garcia de Orta;62116;13335;10937;0;86388
2020-09-01;Região de Saúde Norte;Centro Hospitalar Tâmega e Sousa;95491;16420;9757;0;121668
2020-09-01;Região de Saúde Norte;Centro Hospitalar Vila Nova de Gaia/Espinho;80593;16576;7770;0;104939
2020-09-01;Região de Saúde Norte;Unidade Local de Saúde do Alto Minho;74186;7866;3758;0;85810
2020-10-01;Região de Saúde Alentejo;Hospital Espírito Santo de Évora;36252;9313;0;0;45565
2020-10-01;Região de Saúde Centro;Centro Hospitalar Universitário Cova da Beira;32314;6234;2467;0;41015
2020-10-01;Região de Saúde LVT;Centro Hospitalar do Oeste;73706;19848;6542;0;100096
2020-10-01;Região de Saúde LVT;Centro Hospitalar Médio Tejo;71838;12404;3071;0;87313
2020-10-01;Região de Saúde LVT;Hospital de Cascais;59335;23693;9489;0;92517
2020-10-01;Região de Saúde LVT;Hospital Professor Doutor Fernando Fonseca;115386;25117;13150;0;153653
2020-10-01;Região de Saúde Norte;Centro Hospitalar Trás-os-Montes e Alto Douro;93086;12802;4667;0;110555
2020-10-01;Região de Saúde Norte;Hospital Santa Maria Maior;32880;5416;0;0;38296
2020-11-01;Região de Saúde Centro;Centro Hospitalar Universitário Cova da Beira;35178;6697;2683;0;44558
2020-11-01;Região de Saúde LVT;Hospital Distrital de Santarém;57171;15391;6189;0;78751
2020-11-01;Região de Saúde LVT;Hospital Professor Doutor Fernando Fonseca;125787;27419;14424;0;167630
2020-11-01;Região de Saúde Norte;Centro Hospitalar Universitário do Porto;96692;0;18361;0;115053
2020-11-01;Região de Saúde Norte;Hospital Santa Maria Maior;36229;5770;0;0;41999
2020-11-01;Região de Saúde Norte;Unidade Local de Saúde do Nordeste;73097;0;0;0;73097
2020-12-01;Região de Saúde Algarve;Centro Hospitalar Universitário do Algarve;194831;41967;17804;0;254602
2020-12-01;Região de Saúde Centro;Centro Hospitalar Tondela-Viseu;88947;18352;13420;0;120719
2020-12-01;Região de Saúde Centro;Unidade Local de Saúde de Castelo Branco;40244;5635;1350;0;47229
2020-12-01;Região de Saúde LVT;Centro Hospitalar de Lisboa Ocidental;82717;18068;11830;0;112615
2020-12-01;Região de Saúde LVT;Centro Hospitalar de Setúbal;69750;22145;10206;0;102101
2020-12-01;Região de Saúde LVT;Centro Hospitalar do Oeste;86184;22794;7687;0;116665
2020-12-01;Região de Saúde LVT;Centro Hospitalar Médio Tejo;84045;14337;3593;0;101975
2020-12-01;Região de Saúde LVT;Hospital Distrital de Santarém;61941;16260;6717;0;84918
2020-12-01;Região de Saúde LVT;Hospital Garcia de Orta;80155;17863;14407;0;112425
2020-12-01;Região de Saúde Norte;Centro Hospitalar Trás-os-Montes e Alto Douro;110320;14707;5761;0;130788
2020-12-01;Região de Saúde Norte;Centro Hospitalar Vila Nova de Gaia/Espinho;106487;21919;10170;0;138576
2020-12-01;Região de Saúde Norte;Unidade Local de Saúde de Matosinhos;68921;0;7946;0;76867
2020-12-01;Região de Saúde Norte;Unidade Local de Saúde do Nordeste;79035;0;0;0;79035
2021-01-01;Região de Saúde Alentejo;Hospital Espírito Santo de Évora;3133;523;0;0;3656
2021-01-01;Região de Saúde Alentejo;Unidade Local de Saúde do Baixo Alentejo;4695;902;246;0;5843
2021-01-01;Região de Saúde Alentejo;Unidade Local de Saúde do Norte Alentejano;3886;257;88;0;4231
2021-01-01;Região de Saúde LVT;Centro Hospitalar de Lisboa Ocidental;6250;1236;814;0;8300
2021-01-01;Região de Saúde Norte;Unidade Local de Saúde de Matosinhos;4897;0;572;0;5469
2021-01-01;Região de Saúde Norte;Unidade Local de Saúde do Alto Minho;7241;510;337;0;8088
2021-02-01;Região de Saúde Alentejo;Unidade Local de Saúde do Litoral Alentejano;8526;0;0;0;8526
2021-02-01;Região de Saúde Algarve;Centro Hospitalar Universitário do Algarve;25188;3869;2595;0;31652
2021-02-01;Região de Saúde Centro;Centro Hospitalar e Universitário de Coimbra;19532;4071;2858;0;26461
2021-02-01;Região de Saúde LVT;Centro Hospitalar Universitário Lisboa Central;13735;5361;2337;652;22085
2021-02-01;Região de Saúde LVT;Centro Hospitalar Médio Tejo;11391;1426;434;0;13251
2021-02-01;Região de Saúde LVT;Hospital Distrital de Santarém;8106;1260;863;0;10229
2021-02-01;Região de Saúde Norte;Centro Hospitalar Universitário do Porto;13158;0;2523;0;15681
2021-02-01;Região de Saúde Norte;Centro Hospitalar Entre Douro e Vouga;16808;1511;905;0;19224
2021-02-01;Região de Saúde Norte;Centro Hospitalar Vila Nova de Gaia/Espinho;14452;2379;1371;0;18202
2021-02-01;Região de Saúde Norte;Unidade Local de Saúde de Matosinhos;8865;0;1110;0;9975
2021-02-01;Região de Saúde Norte;Unidade Local de Saúde do Nordeste;10049;0;0;0;10049
2021-03-01;Região de Saúde Alentejo;Unidade Local de Saúde do Litoral Alentejano;13377;0;0;0;13377
2021-03-01;Região de Saúde Centro;Centro Hospitalar e Universitário de Coimbra;31415;6354;4588;0;42357
2021-03-01;Região de Saúde Centro;Hospital Distrital da Figueira da Foz;9168;1407;0;0;10575
2021-03-01;Região de Saúde LVT;Centro Hospitalar Universitário de Lisboa Norte;22873;3693;3143;0;29709
2021-03-01;Região de Saúde LVT;Hospital de Cascais;12981;3801;2210;0;18992
2021-03-01;Região de Saúde Norte;Centro Hospitalar Póvoa de Varzim/Vila do Conde;10643;0;0;0;10643
2021-04-01;Região de Saúde Alentejo;Hospital Espírito Santo de Évora;12745;2297;0;0;15042
2021-04-01;Região de Saúde Alentejo;Unidade Local de Saúde do Litoral Alentejano;18838;0;0;0;18838
2021-04-01;Região de Saúde Centro;Centro Hospitalar Universitário Cova da Beira;11607;1601;874;0;14082
2021-04-01;Região de Saúde Centro;Centro Hospitalar do Baixo Vouga;29097;5018;1851;0;35966
2021-04-01;Região de Saúde Centro;Hospital Distrital da Figueira da Foz;12735;2305;0;0;15040
2021-04-01;Região de Saúde Centro;Unidade Local de Saúde de Castelo Branco;11252;1547;372;0;13171
2021-04-01;Região de Saúde LVT;Centro Hospitalar Universitário de Lisboa Norte;32557;5896;4476;0;42929
2021-04-01;Região de Saúde LVT;Centro Hospitalar Médio Tejo;24989;3451;958;0;29398
2021-04-01;Região de Saúde LVT;Hospital de Cascais;18789;6379;3102;0;28270
2021-04-01;Região de Saúde LVT;Hospital de Loures;23825;6356;3719;0;33900
2021-04-01;Região de Saúde LVT;Hospital Distrital de Santarém;18529;3124;1990;0;23643
2021-05-01;Região de Saúde Alentejo;Unidade Local de Saúde do Litoral Alentejano;25019;0;0;0;25019
2021-05-01;Região de Saúde Centro;Centro Hospitalar de Leiria;40758;6656;3937;0;51351
2021-05-01;Região de Saúde Centro;Hospital Distrital da Figueira da Foz;16824;3438;0;0;20262
2021-05-01;Região de Saúde Centro;Unidade Local de Saúde da Guarda;21854;3529;1403;0;26786
2021-05-01;Região de Saúde Centro;Unidade Local de Saúde de Castelo Branco;14900;2319;469;0;17688
2021-05-01;Região de Saúde LVT;Hospital de Loures;31996;10133;4943;0;47072
2021-05-01;Região de Saúde LVT;Hospital de Vila Franca de Xira;26608;8573;2827;0;38008
2021-05-01;Região de Saúde Norte;Centro Hospitalar Universitário de São João;56626;18623;4486;0;79735
2021-05-01;Região de Saúde Norte;Centro Hospitalar Vila Nova de Gaia/Espinho;43222;8586;3957;0;55765
2021-05-01;Região de Saúde Norte;Hospital de Braga;49992;10221;4638;0;64851
2021-05-01;Região de Saúde Norte;Hospital Santa Maria Maior;16078;1750;0;0;17828
2021-05-01;Região de Saúde Norte;Unidade Local de Saúde de Matosinhos;26625;0;3354;0;29979
2021-06-01;Região de Saúde Alentejo;Unidade Local de Saúde do Litoral Alentejano;31645;0;0;0;31645
2021-06-01;Região de Saúde Centro;Centro Hospitalar do Baixo Vouga;49282;11024;2946;0;63252
2021-06-01;Região de Saúde LVT;Centro Hospitalar de Setúbal;34577;10990;4709;0;50276
2021-06-01;Região de Saúde LVT;Hospital de Loures;40160;14206;6124;0;60490
2021-06-01;Região de Saúde LVT;Hospital de Vila Franca de Xira;33467;12130;3523;0;49120
2021-06-01;Região de Saúde LVT;Hospital Garcia de Orta;37902;9744;6704;0;54350
2021-06-01;Região de Saúde Norte;Unidade Local de Saúde de Matosinhos;33456;0;4162;0;37618
2021-07-01;Região de Saúde Alentejo;Unidade Local de Saúde do Baixo Alentejo;35559;6058;1988;0;43605
2021-07-01;Região de Saúde Centro;Centro Hospitalar Universitário Cova da Beira;22954;4173;1683;0;28810
2021-07-01;Região de Saúde LVT;Centro Hospitalar Barreiro/Montijo;46480;12722;4484;0;63686
2021-07-01;Região de Saúde LVT;Centro Hospitalar Universitário Lisboa Central;60601;32038;9783;3157;105579
2021-07-01;Região de Saúde LVT;Centro Hospitalar de Setúbal;41710;13994;5665;0;61369
2021-07-01;Região de Saúde LVT;Hospital Garcia de Orta;45887;12074;8120;0;66081
2021-07-01;Região de Saúde Norte;Centro Hospitalar Universitário de São João;86016;31657;6650;0;124323
2021-07-01;Região de Saúde Norte;Hospital Santa Maria Maior;24476;3550;0;0;28026
2021-08-01;Região de Saúde Centro;Unidade Local de Saúde da Guarda;40236;6782;2483;0;49501
2021-08-01;Região de Saúde LVT;Hospital de Cascais;46847;20727;7102;0;74676
2021-08-01;Região de Saúde LVT;Hospital de Vila Franca de Xira;47282;17716;5049;0;70047
2021-08-01;Região de Saúde LVT;Hospital Distrital de Santarém;45124;10789;4433;0;60346
2021-08-01;Região de Saúde LVT;Hospital Professor Doutor Fernando Fonseca;97007;23039;10640;0;130686
2021-08-01;Região de Saúde Norte;Centro Hospitalar Universitário de São João;100926;36818;7729;0;145473
2021-08-01;Região de Saúde Norte;Centro Hospitalar do Médio Ave;50992;12193;3801;0;66986
2021-08-01;Região de Saúde Norte;Centro Hospitalar Universitário do Porto;71455;0;12246;0;83701
2021-08-01;Região de Saúde Norte;Hospital da Senhora da Oliveira;55360;12096;5629;0;73085
2021-08-01;Região de Saúde Norte;Hospital Santa Maria Maior;28934;4217;0;0;33151
2021-08-01;Região de Saúde Norte;Unidade Local de Saúde do Nordeste;54053;0;0;0;54053
2021-09-01;Região de Saúde Alentejo;Hospital Espírito Santo de Évora;34324;9101;0;0;43425
2021-09-01;Região de Saúde Alentejo;Unidade Local de Saúde do Litoral Alentejano;53472;0;0;0;53472
2021-09-01;Região de Saúde Centro;Centro Hospitalar Tondela-Viseu;72781;15542;10032;0;98355
2021-09-01;Região de Saúde LVT;Centro Hospitalar Barreiro/Montijo;61928;17353;6041;0;85322
2021-09-01;Região de Saúde LVT;Centro Hospitalar Universitário Lisboa Central;81367;42225;13123;4252;140967
2021-09-01;Região de Saúde LVT;Centro Hospitalar do Oeste;70583;19801;5820;0;96204
2021-09-01;Região de Saúde LVT;Hospital de Cascais;54072;24177;8094;0;86343
2021-09-01;Região de Saúde LVT;Hospital Distrital de Santarém;51689;12780;5055;0;69524
2021-09-01;Região de Saúde Norte;Centro Hospitalar Entre Douro e Vouga;104809;15087;5648;0;125544
2021-09-01;Região de Saúde Norte;Centro Hospitalar Vila Nova de Gaia/Espinho;87855;20889;7694;0;116438
2021-09-01;Região de Saúde Norte;Unidade Local de Saúde de Matosinhos;55134;0;6900;0;62034
2021-10-01;Região de Saúde Alentejo;Unidade Local de Saúde do Litoral Alentejano;60724;0;0;0;60724
2021-10-01;Região de Saúde Algarve;Centro Hospitalar Universitário do Algarve;188122;43216;15794;0;247132
2021-10-01;Região de Saúde Centro;Centro Hospitalar de Leiria;96448;19106;8812;0;124366
2021-10-01;Região de Saúde Centro;Hospital Distrital da Figueira da Foz;39898;10652;0;0;50550
2021-10-01;Região de Saúde LVT;Centro Hospitalar Barreiro/Montijo;70084;21131;6883;0;98098
2021-10-01;Região de Saúde LVT;Hospital de Vila Franca de Xira;60957;25516;6486;0;92959
2021-10-01;Região de Saúde LVT;Hospital Garcia de Orta;69194;21511;12475;0;103180
2021-10-01;Região de Saúde Norte;Centro Hospitalar Universitário do Porto;92416;0;15629;0;108045
2021-10-01;Região de Saúde Norte;Centro Hospitalar Póvoa de Varzim/Vila do Conde;48999;0;0;0;48999
2021-10-01;Região de Saúde Norte;Hospital de Braga;113627;28036;10138;0;151801
2021-10-01;Região de Saúde Norte;Hospital Santa Maria Maior;37193;6403;0;0;43596
2021-10-01;Região de Saúde Norte;Unidade Local de Saúde do Alto Minho;90747;9556;4265;0;104568
2021-11-01;Região de Saúde Alentejo;Unidade Local de Saúde do Baixo Alentejo;61102;11930;3186;0;76218
2021-11-01;Região de Saúde Algarve;Centro Hospitalar Universitário do Algarve;207819;49545;17241;0;274605
2021-11-01;Região de Saúde Centro;Centro Hospitalar e Universitário de Coimbra;148786;46943;18772;0;214501
2021-11-01;Região de Saúde LVT;Centro Hospitalar Universitário Lisboa Central;103379;58501;16299;5325;183504
2021-11-01;Região de Saúde LVT;Centro Hospitalar Universitário de Lisboa Norte;119250;27921;14456;0;161627
2021-11-01;Região de Saúde LVT;Centro Hospitalar Médio Tejo;87429;18969;3302;0;109700
2021-11-01;Região de Saúde Norte;Centro Hospitalar do Médio Ave;72860;20548;5389;0;98797
2021-11-01;Região de Saúde Norte;Hospital de Braga;125707;32383;11129;0;169219
2021-12-01;Região de Saúde Alentejo;Unidade Local de Saúde do Litoral Alentejano;74458;0;0;0;74458
2021-12-01;Região de Saúde Centro;Centro Hospitalar e Universitário de Coimbra;162500;51927;20575;0;235002
2021-12-01;Região de Saúde Centro;Unidade Local de Saúde da Guarda;62616;12359;3725;0;78700
2021-12-01;Região de Saúde LVT;Hospital de Loures;85713;38174;13424;0;137311
2021-12-01;Região de Saúde LVT;Hospital de Vila Franca de Xira;73797;33597;7678;0;115072
2021-12-01;Região de Saúde Norte;Centro Hospitalar Entre Douro e Vouga;146942;24568;7735;0;179245
2021-12-01;Região de Saúde Norte;Centro Hospitalar Vila Nova de Gaia/Espinho;119739;33106;10505;0;163350
2022-01-01;Região de Saúde Centro;Centro Hospitalar Universitário Cova da Beira;3484;746;250;56;4536
2022-01-01;Região de Saúde Centro;Centro Hospitalar de Leiria;9936;1780;924;0;12640
2022-01-01;Região de Saúde Centro;Centro Hospitalar do Baixo Vouga;9931;2393;478;0;12802
2022-01-01;Região de Saúde LVT;Centro Hospitalar de Lisboa Ocidental;7723;2285;1178;0;11186
2022-01-01;Região de Saúde LVT;Hospital de Loures;7772;3165;1079;0;12016
2022-01-01;Região de Saúde LVT;Hospital de Vila Franca de Xira;6332;2563;621;0;9516
2022-01-01;Região de Saúde Norte;Centro Hospitalar Póvoa de Varzim/Vila do Conde;5699;0;0;0;5699
2022-01-01;Região de Saúde Norte;Centro Hospitalar Tâmega e Sousa;12669;2835;1116;0;16620
2022-01-01;Região de Saúde Norte;Hospital de Braga;11563;2734;1050;0;15347
2022-01-01;Região de Saúde Norte;Unidade Local de Saúde de Matosinhos;6581;0;728;0;7309
2022-01-01;Região de Saúde Norte;Unidade Local de Saúde do Nordeste;7868;0;0;0;7868
2022-02-01;Região de Saúde Centro;Centro Hospitalar e Universitário de Coimbra;26992;9098;3570;0;39660
2022-02-01;Região de Saúde Centro;Centro Hospitalar Tondela-Viseu;16135;4128;2329;0;22592
2022-02-01;Região de Saúde Centro;Unidade Local de Saúde da Guarda;10346;1781;555;0;12682
2022-02-01;Região de Saúde LVT;Centro Hospitalar do Oeste;16429;5612;1314;0;23355
2022-02-01;Região de Saúde LVT;Centro Hospitalar Médio Tejo;16366;3894;605;0;20865
2022-02-01;Região de Saúde LVT;Hospital de Cascais;12620;6595;1883;0;21098
2022-02-01;Região de Saúde LVT;Hospital Professor Doutor Fernando Fonseca;25457;7958;2851;0;36266
2022-02-01;Região de Saúde Norte;Centro Hospitalar Universitário de São João;25163;11132;2052;0;38347
2022-02-01;Região de Saúde Norte;Centro Hospitalar do Médio Ave;13707;4214;977;0;18898
2022-02-01;Região de Saúde Norte;Centro Hospitalar Póvoa de Varzim/Vila do Conde;10753;0;0;0;10753
2022-02-01;Região de Saúde Norte;Centro Hospitalar Vila Nova de Gaia/Espinho;19820;5427;1608;0;26855
2022-02-01;Região de Saúde Norte;Hospital da Senhora da Oliveira;15402;4195;1481;0;21078
2022-02-01;Região de Saúde Norte;Unidade Local de Saúde do Nordeste;14885;0;0;0;14885
2022-03-01;Região de Saúde Centro;Centro Hospitalar e Universitário de Coimbra;43617;16937;5399;0;65953
2022-03-01;Região de Saúde Centro;Unidade Local de Saúde da Guarda;16923;3507;895;0;21325
2022-03-01;Região de Saúde LVT;Centro Hospitalar de Lisboa Ocidental;23626;9234;3627;0;36487
2022-03-01;Região de Saúde LVT;Centro Hospitalar de Setúbal;20471;10595;2474;0;33540
2022-03-01;Região de Saúde LVT;Centro Hospitalar Universitário de Lisboa Norte;35604;10031;4201;0;49836
2022-03-01;Região de Saúde LVT;Centro Hospitalar Médio Tejo;26652;7598;940;0;35190
2022-03-01;Região de Saúde LVT;Hospital de Cascais;20519;12358;2960;0;35837
2022-03-01;Região de Saúde Norte;Hospital de Braga;35622;10577;3175;0;49374
2022-04-01;Região de Saúde Alentejo;Unidade Local de Saúde do Norte Alentejano;22541;2950;759;0;26250
2022-04-01;Região de Saúde Centro;Centro Hospitalar Tondela-Viseu;35042;10868;4663;0;50573
2022-04-01;Região de Saúde Centro;Hospital Distrital da Figueira da Foz;16717;5938;0;0;22655
2022-04-01;Região de Saúde LVT;Centro Hospitalar de Setúbal;27666;14570;3366;0;45602
2022-04-01;Região de Saúde LVT;Centro Hospitalar do Oeste;36181;14751;2648;0;53580
2022-04-01;Região de Saúde LVT;Hospital de Cascais;27949;17118;4017;0;49084
2022-05-01;Região de Saúde Alentejo;Unidade Local de Saúde do Baixo Alentejo;33375;8540;1521;0;43436
2022-05-01;Região de Saúde Centro;Centro Hospitalar Tondela-Viseu;44857;14417;5942;0;65216
2022-05-01;Região de Saúde Centro;Hospital Distrital da Figueira da Foz;21510;7724;0;0;29234
2022-05-01;Região de Saúde Centro;Unidade Local de Saúde da Guarda;29975;6179;1618;0;37772
2022-05-01;Região de Saúde LVT;Centro Hospitalar Universitário de Lisboa Norte;62384;17336;7316;0;87036
2022-05-01;Região de Saúde LVT;Hospital Professor Doutor Fernando Fonseca;69331;25234;7827;0;102392
2022-05-01;Região de Saúde Norte;Hospital Santa Maria Maior;21267;5719;0;0;26986
2022-05-01;Região de Saúde Norte;Unidade Local de Saúde do Nordeste;41800;0;0;0;41800
2022-06-01;Região de Saúde LVT;Centro Hospitalar de Lisboa Ocidental;48505;18576;7243;0;74324
2022-06-01;Região de Saúde LVT;Hospital Professor Doutor Fernando Fonseca;84036;29527;9367;0;122930
2022-06-01;Região de Saúde Norte;Centro Hospitalar Trás-os-Montes e Alto Douro;71740;14591;3750;0;90081
2022-06-01;Região de Saúde Norte;Centro Hospitalar Vila Nova de Gaia/Espinho;65707;21959;4305;0;91971
2022-06-01;Região de Saúde Norte;Unidade Local de Saúde de Matosinhos;41927;0;4546;0;46473
2022-07-01;Região de Saúde Alentejo;Unidade Local de Saúde do Litoral Alentejano;53077;0;0;0;53077
2022-07-01;Região de Saúde Centro;Centro Hospitalar de Leiria;78009;18854;6760;0;103623
2022-07-01;Região de Saúde Centro;Unidade Local de Saúde de Castelo Branco;28720;7938;918;0;37576
2022-07-01;Região de Saúde LVT;Centro Hospitalar de Setúbal;49675;25573;6074;0;81322
2022-07-01;Região de Saúde Norte;Unidade Local de Saúde de Matosinhos;49148;0;5422;0;54570
2022-07-01;Região de Saúde Norte;Unidade Local de Saúde do Nordeste;58639;0;0;0;58639
2022-08-01;Região de Saúde Centro;Centro Hospitalar e Universitário de Coimbra;121237;44978;15089;0;181304
2022-08-01;Região de Saúde Centro;Hospital Distrital da Figueira da Foz;36285;12235;0;0;48520
2022-08-01;Região de Saúde LVT;Centro Hospitalar de Setúbal;56671;27958;6986;0;91615
2022-08-01;Região de Saúde LVT;Centro Hospitalar Médio Tejo;76680;19974;2652;0;99306
2022-08-01;Região de Saúde LVT;Hospital de Loures;63123;33001;8323;0;104447
2022-08-01;Região de Saúde LVT;Hospital de Vila Franca de Xira;53362;28625;5686;0;87673
2022-08-01;Região de Saúde Norte;Centro Hospitalar Universitário de São João;112593;53138;8541;0;174272
2022-08-01;Região de Saúde Norte;Centro Hospitalar Trás-os-Montes e Alto Douro;99029;18804;5270;0;123103
2022-08-01;Região de Saúde Norte;Centro Hospitalar Vila Nova de Gaia/Espinho;89274;28111;5562;0;122947
2022-09-01;Região de Saúde Centro;Hospital Distrital da Figueira da Foz;40682;13552;0;0;54234
2022-09-01;Região de Saúde Centro;Unidade Local de Saúde de Castelo Branco;37105;9719;1191;0;48015
2022-09-01;Região de Saúde LVT;Centro Hospitalar de Lisboa Ocidental;71810;24815;10772;0;107397
2022-09-01;Região de Saúde LVT;Centro Hospitalar Universitário de Lisboa Norte;112500;28934;13398;0;154832
2022-09-01;Região de Saúde LVT;Hospital de Vila Franca de Xira;60280;32111;6470;0;98861
2022-09-01;Região de Saúde LVT;Hospital Professor Doutor Fernando Fonseca;128495;41161;14559;0;184215
2022-09-01;Região de Saúde LVT;Hospital Garcia de Orta;65964;32679;11750;0;110393
2022-09-01;Região de Saúde Norte;Centro Hospitalar Universitário de São João;126680;59089;9512;0;195281
2022-09-01;Região de Saúde Norte;Centro Hospitalar do Médio Ave;67118;22085;4993;0;94196
2022-09-01;Região de Saúde Norte;Centro Hospitalar Universitário do Porto;94878;0;15749;0;110627
2022-09-01;Região de Saúde Norte;Centro Hospitalar Trás-os-Montes e Alto Douro;110662;20673;5970;0;137305
2022-10-01;Região de Saúde Centro;Centro Hospitalar Universitário Cova da Beira;39922;11067;3169;411;54569
2022-10-01;Região de Saúde Centro;Centro Hospitalar do Baixo Vouga;107624;33854;5292;0;146770
2022-10-01;Região de Saúde Centro;Unidade Local de Saúde da Guarda;62060;11772;3362;0;77194
2022-10-01;Região de Saúde LVT;Centro Hospitalar Universitário Lisboa Central;112050;65215;16563;5477;199305
2022-10-01;Região de Saúde LVT;Centro Hospitalar de Setúbal;70513;35398;8682;0;114593
2022-10-01;Região de Saúde LVT;Hospital de Vila Franca de Xira;67604;38007;7205;0;112816
2022-10-01;Região de Saúde LVT;Hospital Professor Doutor Fernando Fonseca;144261;48013;16475;0;208749
2022-10-01;Região de Saúde LVT;Hospital Garcia de Orta;73648;38235;13008;0;124891
2022-10-01;Região de Saúde Norte;Centro Hospitalar Universitário de São João;141446;68218;10547;0;220211
2022-10-01;Região de Saúde Norte;Centro Hospitalar Universitário do Porto;105682;0;17594;0;123276
2022-10-01;Região de Saúde Norte;Centro Hospitalar Tâmega e Sousa;126561;31772;12060;0;170393
2022-10-01;Região de Saúde Norte;Unidade Local de Saúde do Alto Minho;113072;15542;5083;0;133697
2022-11-01;Região de Saúde Alentejo;Hospital Espírito Santo de Évora;49510;18546;0;0;68056
2022-11-01;Região de Saúde Alentejo;Unidade Local de Saúde do Baixo Alentejo;74577;16965;3352;0;94894
2022-11-01;Região de Saúde LVT;Centro Hospitalar Universitário Lisboa Central;124936;76111;18484;6026;225557
2022-11-01;Região de Saúde LVT;Centro Hospitalar Universitário de Lisboa Norte;136827;38538;16236;0;191601
2022-11-01;Região de Saúde LVT;Centro Hospitalar Médio Tejo;106084;30618;3567;0;140269
2022-11-01;Região de Saúde LVT;Hospital Garcia de Orta;80857;43783;14200;0;138840
2022-11-01;Região de Saúde Norte;Centro Hospitalar Universitário de São João;155143;77337;11543;0;244023
2022-11-01;Região de Saúde Norte;Centro Hospitalar Póvoa de Varzim/Vila do Conde;67910;0;0;0;67910
2022-11-01;Região de Saúde Norte;Centro Hospitalar Vila Nova de Gaia/Espinho;123460;42398;7508;0;173366
2022-11-01;Região de Saúde Norte;Unidade Local de Saúde do Alto Minho;125276;18374;5581;0;149231
2022-12-01;Região de Saúde Centro;Centro Hospitalar de Leiria;135220;34450;11866;0;181536
2022-12-01;Região de Saúde Centro;Centro Hospitalar do Baixo Vouga;129350;43663;6361;0;179374
2022-12-01;Região de Saúde LVT;Centro Hospitalar Barreiro/Montijo;105780;39607;9859;0;155246
2022-12-01;Região de Saúde LVT;Centro Hospitalar de Lisboa Ocidental;94947;35764;14029;0;144740
2022-12-01;Região de Saúde LVT;Hospital Garcia de Orta;83298;47668;15448;0;146414
2022-12-01;Região de Saúde Norte;Centro Hospitalar Entre Douro e Vouga;182400;37594;9111;0;229105
2022-12-01;Região de Saúde Norte;Centro Hospitalar Tâmega e Sousa;151081;39813;14548;0;205442
2022-12-01;Região de Saúde Norte;Centro Hospitalar Trás-os-Montes e Alto Douro;148544;31889;7958;0;188391
2022-12-01;Região de Saúde Norte;Unidade Local de Saúde do Nordeste;104009;0;0;0;104009
2023-01-01;Região de Saúde Alentejo;Unidade Local de Saúde do Baixo Alentejo;7562;1484;287;0;9333
2023-01-01;Região de Saúde Centro;Centro Hospitalar e Universitário de Coimbra;15007;5575;1878;0;22460
2023-01-01;Região de Saúde LVT;Centro Hospitalar Universitário de Lisboa Norte;11259;3563;1421;0;16243
2023-01-01;Região de Saúde LVT;Hospital de Cascais;7298;4052;1027;0;12377
2023-01-01;Região de Saúde LVT;Hospital de Loures;6731;4328;1068;0;12127
2023-01-01;Região de Saúde LVT;Hospital de Vila Franca de Xira;6611;3850;663;0;11124
2023-01-01;Região de Saúde LVT;Hospital Distrital de Santarém;6730;2663;670;0;10063
2023-01-01;Região de Saúde Norte;Centro Hospitalar Entre Douro e Vouga;15383;3082;673;0;19138
2023-01-01;Região de Saúde Norte;Centro Hospitalar Trás-os-Montes e Alto Douro;12410;2733;646;0;15789
2023-01-01;Região de Saúde Norte;Hospital de Braga;11905;3831;1026;0;16762
2023-01-01;Região de Saúde Norte;Unidade Local de Saúde do Alto Minho;11647;1757;493;0;13897
2023-02-01;Região de Saúde Alentejo;Unidade Local de Saúde do Baixo Alentejo;14901;2880;554;0;18335
2023-02-01;Região de Saúde Centro;Centro Hospitalar Tondela-Viseu;17762;5907;2428;0;26097
2023-02-01;Região de Saúde LVT;Hospital de Loures;13371;8728;2074;0;24173
2023-02-01;Região de Saúde LVT;Hospital Professor Doutor Fernando Fonseca;28532;10200;3188;0;41920
2023-02-01;Região de Saúde Norte;Centro Hospitalar Universitário de São João;27556;12762;1945;0;42263
2023-02-01;Região de Saúde Norte;Centro Hospitalar do Médio Ave;14096;5599;1115;0;20810
2023-02-01;Região de Saúde Norte;Centro Hospitalar Entre Douro e Vouga;29955;6005;1319;0;37279
2023-02-01;Região de Saúde Norte;Centro Hospitalar Póvoa de Varzim/Vila do Conde;11678;0;0;0;11678
2023-02-01;Região de Saúde Norte;Hospital de Braga;23513;7800;2034;0;33347
2023-02-01;Região de Saúde Norte;Hospital Santa Maria Maior;8572;2478;0;0;11050
2023-02-01;Região de Saúde Norte;Unidade Local de Saúde do Alto Minho;22532;3700;964;0;27196
2023-03-01;Região de Saúde Algarve;Centro Hospitalar Universitário do Algarve;67030;18012;4703;0;89745
2023-03-01;Região de Saúde Centro;Centro Hospitalar Universitário Cova da Beira;12234;3999;966;86;17285
2023-03-01;Região de Saúde Centro;Centro Hospitalar do Baixo Vouga;32065;11013;1599;0;44677
2023-03-01;Região de Saúde Centro;Hospital Distrital da Figueira da Foz;12334;4891;0;0;17225
2023-03-01;Região de Saúde LVT;Hospital de Loures;20174;11690;3205;0;35069
2023-03-01;Região de Saúde LVT;Hospital Distrital de Santarém;20344;8206;1892;0;30442
2023-04-01;Região de Saúde Centro;Centro Hospitalar do Baixo Vouga;42832;14470;2195;0;59497
2023-04-01;Região de Saúde Centro;Centro Hospitalar e Universitário de Coimbra;58823;22020;6996;0;87839
2023-04-01;Região de Saúde Centro;Unidade Local de Saúde de Castelo Branco;17174;5032;570;0;22776
2023-04-01;Região de Saúde LVT;Centro Hospitalar Barreiro/Montijo;37448;13593;3109;0;54150
2023-04-01;Região de Saúde LVT;Centro Hospitalar de Lisboa Ocidental;30408;11219;4256;0;45883
2023-04-01;Região de Saúde LVT;Hospital de Cascais;29611;16834;4336;0;50781
2023-04-01;Região de Saúde Norte;Centro Hospitalar Tâmega e Sousa;50335;12846;4854;0;68035
2023-04-01;Região de Saúde Norte;Centro Hospitalar Universitário de Santo António;41378;0;6553;0;47931
2023-04-01;Região de Saúde Norte;Unidade Local de Saúde do Nordeste;32695;0;0;0;32695
2023-05-01;Região de Saúde Centro;Centro Hospitalar e Universitário de Coimbra;75049;28047;8989;0;112085
2023-05-01;Região de Saúde Centro;Unidade Local de Saúde da Guarda;32129;6945;1701;0;40775
2023-05-01;Região de Saúde LVT;Hospital de Cascais;37482;21402;5530;0;64414
2023-05-01;Região de Saúde LVT;Hospital de Loures;33999;16856;5579;0;56434
2023-05-01;Região de Saúde LVT;Hospital Professor Doutor Fernando Fonseca;72900;25668;8136;0;106704
2023-05-01;Região de Saúde Norte;Centro Hospitalar Vila Nova de Gaia/Espinho;57042;19173;3383;0;79598
2023-05-01;Região de Saúde Norte;Hospital Santa Maria Maior;22134;5652;0;0;27786
2023-06-01;Região de Saúde LVT;Centro Hospitalar Universitário Lisboa Central;67158;41161;11042;3069;122430
2023-06-01;Região de Saúde LVT;Hospital de Vila Franca de Xira;40559;24086;4158;0;68803
2023-06-01;Região de Saúde Norte;Centro Hospitalar Vila Nova de Gaia/Espinho;69093;22650;4043;0;95786
2023-06-01;Região de Saúde Norte;Hospital da Senhora da Oliveira;52095;17561;5209;0;74865
2023-07-01;Região de Saúde Alentejo;Unidade Local de Saúde do Litoral Alentejano;56261;0;0;0;56261
2023-07-01;Região de Saúde Alentejo;Unidade Local de Saúde do Norte Alentejano;45215;5118;1453;0;51786
2023-07-01;Região de Saúde Centro;Centro Hospitalar do Baixo Vouga;77775;25260;4032;0;107067
2023-07-01;Região de Saúde Centro;Centro Hospitalar Tondela-Viseu;65950;20107;8642;0;94699
2023-07-01;Região de Saúde LVT;Hospital Garcia de Orta;49866;27967;10300;0;88133
2023-07-01;Região de Saúde Norte;Centro Hospitalar Vila Nova de Gaia/Espinho;81747;26084;4835;0;112666
2023-07-01;Região de Saúde Norte;Hospital de Braga;88609;27630;8089;0;124328
2023-07-01;Região de Saúde Norte;Unidade Local de Saúde de Matosinhos;48372;0;5512;0;53884
2023-08-01;Região de Saúde LVT;Centro Hospitalar Barreiro/Montijo;76819;23899;6176;0;106894
2023-08-01;Região de Saúde LVT;Centro Hospitalar Universitário Lisboa Central;91135;51966;15451;4211;162763
2023-08-01;Região de Saúde LVT;Hospital de Cascais;61082;31585;9333;0;102000
2023-08-01;Região de Saúde LVT;Hospital Distrital de Santarém;55666;20441;5175;0;81282
2023-08-01;Região de Saúde LVT;Hospital Garcia de Orta;58176;31173;11738;0;101087
2023-08-01;Região de Saúde Norte;Centro Hospitalar Póvoa de Varzim/Vila do Conde;46997;0;0;0;46997
2023-08-01;Região de Saúde Norte;Centro Hospitalar Trás-os-Montes e Alto Douro;104578;20221;5769;0;130568
2023-08-01;Região de Saúde Norte;Hospital Santa Maria Maior;36795;8249;0;0;45044
2023-08-01;Região de Saúde Norte;Unidade Local de Saúde de Matosinhos;56266;0;6397;0;62663
2023-08-01;Região de Saúde Norte;Unidade Local de Saúde do Nordeste;68746;0;0;0;68746
2023-09-01;Região de Saúde Algarve;Centro Hospitalar Universitário do Algarve;219928;51301;14191;0;285420
2023-09-01;Região de Saúde Centro;Centro Hospitalar e Universitário de Coimbra;138167;47009;17218;0;202394
2023-09-01;Região de Saúde LVT;Centro Hospitalar de Lisboa Ocidental;69995;22203;11496;0;103694
2023-09-01;Região de Saúde LVT;Centro Hospitalar Universitário de Lisboa Norte;106437;33467;10319;0;150223
2023-09-01;Região de Saúde LVT;Hospital Garcia de Orta;65725;34588;13212;0;113525
2023-09-01;Região de Saúde Norte;Centro Hospitalar do Médio Ave;66417;23033;5329;0;94779
2023-09-01;Região de Saúde Norte;Centro Hospitalar Entre Douro e Vouga;140333;25307;6652;0;172292
2023-10-01;Região de Saúde Alentejo;Unidade Local de Saúde do Baixo Alentejo;75233;14386;3494;0;93113
2023-10-01;Região de Saúde LVT;Centro Hospitalar de Setúbal;63301;27425;8289;0;99015
2023-10-01;Região de Saúde LVT;Centro Hospitalar do Oeste;99327;37293;3046;0;139666
2023-10-01;Região de Saúde LVT;Hospital de Loures;66761;25636;11743;0;104140
2023-10-01;Região de Saúde LVT;Hospital de Vila Franca de Xira;68161;37352;7254;0;112767
2023-10-01;Região de Saúde LVT;Hospital Garcia de Orta;73027;39045;14671;0;126743
2023-10-01;Região de Saúde Norte;Centro Hospitalar do Médio Ave;73520;26217;5995;0;105732
2023-10-01;Região de Saúde Norte;Centro Hospitalar Entre Douro e Vouga;155409;28713;7406;0;191528
2023-10-01;Região de Saúde Norte;Centro Hospitalar Trás-os-Montes e Alto Douro;129533;24692;7227;0;161452
2023-10-01;Região de Saúde Norte;Hospital da Senhora da Oliveira;87692;27986;9302;0;124980
2023-10-01;Região de Saúde Norte;Unidade Local de Saúde do Nordeste;84792;0;0;0;84792
2023-11-01;Região de Saúde Centro;Centro Hospitalar Universitário Cova da Beira;45944;13541;3755;364;63604
2023-11-01;Região de Saúde LVT;Centro Hospitalar Universitário de Lisboa Norte;127832;42138;10319;0;180289
2023-11-01;Região de Saúde LVT;Hospital de Cascais;82014;44196;13946;0;140156
2023-11-01;Região de Saúde LVT;Hospital de Loures;72199;28391;12922;0;113512
2023-11-01;Região de Saúde Norte;Centro Hospitalar Universitário de Santo António;117492;0;18828;0;136320
2023-11-01;Região de Saúde Norte;Unidade Local de Saúde de Matosinhos;76471;0;8649;0;85120
2023-12-01;Região de Saúde Centro;Centro Hospitalar Tondela-Viseu;114643;35086;14894;0;164623
2023-12-01;Região de Saúde LVT;Centro Hospitalar Universitário Lisboa Central;135870;81630;24350;6269;248119
2023-12-01;Região de Saúde LVT;Centro Hospitalar de Setúbal;74816;34024;9753;0;118593
2023-12-01;Região de Saúde LVT;Centro Hospitalar Universitário de Lisboa Norte;138346;47249;10319;0;195914
2023-12-01;Região de Saúde LVT;Hospital Garcia de Orta;86413;47187;16888;0;150488
2023-12-01;Região de Saúde Norte;Centro Hospitalar Póvoa de Varzim/Vila do Conde;72262;0;0;0;72262
2023-12-01;Região de Saúde Norte;Centro Hospitalar Tâmega e Sousa;152668;34150;14562;0;201380
2023-12-01;Região de Saúde Norte;Hospital de Braga;152600;47808;12728;0;213136
2023-12-01;Região de Saúde Norte;Unidade Local de Saúde de Matosinhos;83269;0;9345;0;92614
2023-12-01;Região de Saúde Norte;Unidade Local de Saúde do Alto Minho;143409;20764;6894;0;171067
2019-01-01;Região de Saúde Centro;Hospital Distrital da Figueira da Foz;4787;1926;0;0;6713
2019-01-01;Região de Saúde LVT;Hospital de Cascais;7840;5071;1220;0;14131
2019-01-01;Região de Saúde LVT;Hospital Distrital de Santarém;8491;2880;778;0;12149
2019-01-01;Região de Saúde Norte;Centro Hospitalar Universitário de São João;13443;7215;1294;0;21952
2019-01-01;Região de Saúde Norte;Centro Hospitalar Vila Nova de Gaia/Espinho;10670;4106;1072;0;15848
2019-02-01;Região de Saúde Alentejo;Unidade Local de Saúde do Litoral Alentejano;16329;0;0;0;16329
2019-02-01;Região de Saúde Algarve;Centro Hospitalar Universitário do Algarve;41004;13735;3255;0;57994
2019-02-01;Região de Saúde Centro;Hospital Distrital da Figueira da Foz;8922;3515;0;0;12437
2019-02-01;Região de Saúde Centro;Unidade Local de Saúde da Guarda;13896;2968;600;0;17464
2019-02-01;Região de Saúde LVT;Centro Hospitalar Universitário de Lisboa Norte;29949;8034;2978;0;40961
2019-02-01;Região de Saúde LVT;Centro Hospitalar Médio Tejo;19619;5332;460;0;25411
2019-02-01;Região de Saúde LVT;Hospital de Loures;19841;11402;2779;0;34022
2019-02-01;Região de Saúde LVT;Hospital Garcia de Orta;16559;8382;2827;0;27768
2019-02-01;Região de Saúde Norte;Hospital da Senhora da Oliveira;16419;6364;1550;0;24333
2019-03-01;Região de Saúde Alentejo;Unidade Local de Saúde do Litoral Alentejano;23733;0;0;0;23733
2019-03-01;Região de Saúde Algarve;Centro Hospitalar Universitário do Algarve;62053;20138;4992;0;87183
2019-03-01;Região de Saúde Centro;Hospital Distrital da Figueira da Foz;13363;5099;0;0;18462
2019-03-01;Região de Saúde LVT;Centro Hospitalar Barreiro/Montijo;26979;10160;2615;0;39754
2019-03-01;Região de Saúde LVT;Centro Hospitalar de Lisboa Ocidental;28337;8942;3846;0;41125
2019-03-01;Região de Saúde Norte;Centro Hospitalar Universitário do Porto;31565;0;5271;0;36836
2019-03-01;Região de Saúde Norte;Centro Hospitalar Vila Nova de Gaia/Espinho;31538;11686;2980;0;46204
2019-03-01;Região de Saúde Norte;Hospital Santa Maria Maior;12341;4025;0;0;16366
2019-04-01;Região de Saúde Alentejo;Unidade Local de Saúde do Norte Alentejano;27158;2772;448;0;30378
2019-04-01;Região de Saúde LVT;Centro Hospitalar de Setúbal;30032;14030;4273;0;48335
2019-04-01;Região de Saúde LVT;Hospital de Vila Franca de Xira;28442;15630;3284;0;47356
2019-04-01;Região de Saúde Norte;Centro Hospitalar Entre Douro e Vouga;56586;11230;2978;0;70794
2019-04-01;Região de Saúde Norte;Centro Hospitalar Vila Nova de Gaia/Espinho;41816;14658;3973;0;60447
2019-04-01;Região de Saúde Norte;Unidade Local de Saúde do Alto Minho;45136;7391;2079;0;54606
2019-05-01;Região de Saúde Centro;Unidade Local de Saúde de Castelo Branco;21538;4891;715;0;27144
2019-05-01;Região de Saúde LVT;Centro Hospitalar Universitário Lisboa Central;58379;32841;8742;2656;102618
2019-05-01;Região de Saúde LVT;Hospital de Loures;50171;26342;7307;0;83820
2019-05-01;Região de Saúde Norte;Centro Hospitalar Universitário do Porto;53165;0;8978;0;62143
2019-05-01;Região de Saúde Norte;Centro Hospitalar Vila Nova de Gaia/Espinho;53331;18361;5065;0;76757
2019-06-01;Região de Saúde Alentejo;Unidade Local de Saúde do Norte Alentejano;40456;4191;639;0;45286
2019-06-01;Região de Saúde Centro;Centro Hospitalar do Baixo Vouga;62124;20073;3492;0;85689
2019-06-01;Região de Saúde Centro;Unidade Local de Saúde da Guarda;40204;7952;1967;0;50123
2019-06-01;Região de Saúde LVT;Centro Hospitalar Universitário de Lisboa Norte;92042;22807;9241;0;124090
2019-06-01;Região de Saúde LVT;Hospital Garcia de Orta;50931;22517;8644;0;82092
2019-06-01;Região de Saúde Norte;Centro Hospitalar Póvoa de Varzim/Vila do Conde;36346;0;0;0;36346
2019-06-01;Região de Saúde Norte;Centro Hospitalar Tâmega e Sousa;70195;18642;7151;0;95988
2019-06-01;Região de Saúde Norte;Centro Hospitalar Trás-os-Montes e Alto Douro;73213;14545;2254;0;90012
2019-06-01;Região de Saúde Norte;Hospital da Senhora da Oliveira;49143;15401;4896;0;69440
2019-06-01;Região de Saúde Norte;Unidade Local de Saúde do Nordeste;55344;0;0;0;55344
2019-07-01;Região de Saúde Alentejo;Unidade Local de Saúde do Baixo Alentejo;50342;9811;2169;0;62322
2019-07-01;Região de Saúde Alentejo;Unidade Local de Saúde do Norte Alentejano;47385;4833;727;0;52945
2019-07-01;Região de Saúde Centro;Centro Hospitalar Tondela-Viseu;64373;19180;9025;0;92578
2019-07-01;Região de Saúde Centro;Unidade Local de Saúde de Castelo Branco;30299;6466;958;0;37723
2019-07-01;Região de Saúde LVT;Centro Hospitalar Barreiro/Montijo;62589;21763;6377;0;90729
2019-07-01;Região de Saúde LVT;Centro Hospitalar Médio Tejo;67827;16409;1634;0;85870
2019-07-01;Região de Saúde Norte;Centro Hospitalar Tâmega e Sousa;83158;20954;8579;0;112691
2019-07-01;Região de Saúde Norte;Hospital da Senhora da Oliveira;57858;17568;5856;0;81282
2019-07-01;Região de Saúde Norte;Hospital de Braga;90681;28850;9698;0;129229
2019-07-01;Região de Saúde Norte;Hospital Santa Maria Maior;28604;8239;0;0;36843
2019-07-01;Região de Saúde Norte;Unidade Local de Saúde do Nordeste;64664;0;0;0;64664
2019-08-01;Região de Saúde Centro;Hospital Distrital da Figueira da Foz;36729;12352;0;0;49081
2019-08-01;Região de Saúde LVT;Centro Hospitalar de Lisboa Ocidental;75199;20578;10516;0;106293
2019-08-01;Região de Saúde LVT;Hospital de Vila Franca de Xira;57434;28115;6931;0;92480
2019-08-01;Região de Saúde LVT;Hospital Garcia de Orta;69467;28830;11853;0;110150
2019-08-01;Região de Saúde Norte;Centro Hospitalar Trás-os-Montes e Alto Douro;100551;18524;3191;0;122266
2019-09-01;Região de Saúde Alentejo;Unidade Local de Saúde do Baixo Alentejo;64326;11755;3012;0;79093
2019-09-01;Região de Saúde Centro;Centro Hospitalar e Universitário de Coimbra;156727;46401;18938;0;222066
2019-09-01;Região de Saúde LVT;Centro Hospitalar de Setúbal;69485;28963;10464;0;108912
2019-09-01;Região de Saúde LVT;Centro Hospitalar do Oeste;91983;33100;8026;0;133109
2019-09-01;Região de Saúde LVT;Hospital de Loures;90414;42687;13747;0;146848
2019-09-01;Região de Saúde LVT;Hospital Distrital de Santarém;64921;27039;6184;0;98144
2019-09-01;Região de Saúde LVT;Hospital Garcia de Orta;78399;32452;13489;0;124340
2019-09-01;Região de Saúde Norte;Centro Hospitalar Universitário do Porto;97322;0;17400;0;114722
2019-09-01;Região de Saúde Norte;Centro Hospitalar Entre Douro e Vouga;130168;22263;7059;0;159490
2019-09-01;Região de Saúde Norte;Centro Hospitalar Vila Nova de Gaia/Espinho;97753;29686;9532;0;136971
2019-10-01;Região de Saúde Alentejo;Unidade Local de Saúde do Baixo Alentejo;71837;13152;3423;0;88412
2019-10-01;Região de Saúde Centro;Centro Hospitalar de Leiria;117670;27331;10987;0;155988
2019-10-01;Região de Saúde Centro;Centro Hospitalar Tondela-Viseu;93393;26683;13344;0;133420
2019-10-01;Região de Saúde Centro;Unidade Local de Saúde da Guarda;67794;12718;3211;0;83723
2019-10-01;Região de Saúde LVT;Centro Hospitalar Barreiro/Montijo;90712;30657;9420;0;130789
2019-10-01;Região de Saúde LVT;Centro Hospitalar de Lisboa Ocidental;95029;26084;13237;0;134350
2019-10-01;Região de Saúde LVT;Centro Hospitalar de Setúbal;77349;32800;11710;0;121859
2019-10-01;Região de Saúde LVT;Centro Hospitalar Médio Tejo;97999;22456;2542;0;122997
2019-10-01;Região de Saúde LVT;Hospital de Cascais;77279;42856;12463;0;132598
2019-10-01;Região de Saúde Norte;Centro Hospitalar do Médio Ave;76847;26747;6235;0;109829
2019-10-01;Região de Saúde Norte;Hospital Santa Maria Maior;41211;11131;0;0;52342
2019-10-01;Região de Saúde Norte;Unidade Local de Saúde do Nordeste;92938;0;0;0;92938
2019-11-01;Região de Saúde Norte;Centro Hospitalar Universitário de São João;153623;68657;13706;0;235986
2019-11-01;Região de Saúde Norte;Centro Hospitalar do Médio Ave;84104;29882;6810;0;120796
2019-11-01;Região de Saúde Norte;Centro Hospitalar Entre Douro e Vouga;159493;28605;8616;0;196714
2019-11-01;Região de Saúde Norte;Unidade Local de Saúde do Nordeste;102324;0;0;0;102324
2019-12-01;Região de Saúde LVT;Centro Hospitalar de Lisboa Ocidental;114240;33137;15557;0;162934
2019-12-01;Região de Saúde LVT;Centro Hospitalar Médio Tejo;117459;28726;3126;0;149311
2019-12-01;Região de Saúde Norte;Centro Hospitalar Entre Douro e Vouga;175281;32902;9439;0;217622
2019-12-01;Região de Saúde Norte;Centro Hospitalar Vila Nova de Gaia/Espinho;130179;43035;12660;0;185874
2019-12-01;Região de Saúde Norte;Unidade Local de Saúde do Alto Minho;140021;20384;6715;0;167120
2020-01-01;Região de Saúde Algarve;Centro Hospitalar Universitário do Algarve;22920;7738;1750;0;32408
2020-01-01;Região de Saúde Centro;Centro Hospitalar do Baixo Vouga;11359;3950;606;0;15915
2020-01-01;Região de Saúde Centro;Unidade Local de Saúde da Guarda;7037;1487;374;0;8898
2020-01-01;Região de Saúde LVT;Centro Hospitalar Barreiro/Montijo;9989;3892;945;0;14826
2020-01-01;Região de Saúde LVT;Hospital de Cascais;8163;4748;1083;0;13994
2020-01-01;Região de Saúde LVT;Hospital Professor Doutor Fernando Fonseca;15945;5634;1816;0;23395
2020-01-01;Região de Saúde Norte;Centro Hospitalar Póvoa de Varzim/Vila do Conde;6734;0;0;0;6734
2020-01-01;Região de Saúde Norte;Centro Hospitalar Vila Nova de Gaia/Espinho;11078;3972;1073;0;16123
2020-01-01;Região de Saúde Norte;Unidade Local de Saúde do Nordeste;10196;0;0;0;10196
2020-02-01;Região de Saúde Algarve;Centro Hospitalar Universitário do Algarve;43886;14614;3391;0;61891
2020-02-01;Região de Saúde Centro;Centro Hospitalar de Leiria;23338;5923;2076;0;31337
2020-02-01;Região de Saúde LVT;Hospital de Loures;19463;11015;3039;0;33517
2020-02-01;Região de Saúde LVT;Hospital de Vila Franca de Xira;14786;9425;1689;0;25900
2020-02-01;Região de Saúde Norte;Centro Hospitalar Universitário do Porto;21497;0;3672;0;25169
2020-02-01;Região de Saúde Norte;Centro Hospitalar Entre Douro e Vouga;30469;6273;1600;0;38342
2020-02-01;Região de Saúde Norte;Hospital de Braga;25044;8802;2653;0;36499
2020-02-01;Região de Saúde Norte;Unidade Local de Saúde de Matosinhos;13526;0;1811;0;15337
2020-02-01;Região de Saúde Norte;Unidade Local de Saúde do Nordeste;18785;0;0;0;18785
2020-03-01;Região de Saúde Algarve;Centro Hospitalar Universitário do Algarve;58194;17696;4615;0;80505
2020-03-01;Região de Saúde Centro;Centro Hospitalar de Leiria;31317;7347;2857;0;41521
2020-03-01;Região de Saúde Centro;Hospital Distrital da Figueira da Foz;11459;4025;0;0;15484
2020-03-01;Região de Saúde Centro;Unidade Local de Saúde da Guarda;17658;3614;1048;0;22320
2020-03-01;Região de Saúde LVT;Centro Hospitalar Universitário Lisboa Central;30366;18952;4910;1432;55660
2020-03-01;Região de Saúde LVT;Centro Hospitalar do Oeste;27033;10895;2340;0;40268
2020-03-01;Região de Saúde LVT;Hospital de Vila Franca de Xira;19666;11252;2362;0;33280
2020-03-01;Região de Saúde Norte;Centro Hospitalar do Médio Ave;20478;7184;1521;0;29183
2020-03-01;Região de Saúde Norte;Centro Hospitalar Tâmega e Sousa;33146;8747;3404;0;45297
2020-03-01;Região de Saúde Norte;Hospital Santa Maria Maior;11090;3501;0;0;14591
2020-03-01;Região de Saúde Norte;Unidade Local de Saúde do Nordeste;24637;0;0;0;24637
2020-04-01;Região de Saúde Alentejo;Hospital Espírito Santo de Évora;14370;4916;0;0;19286
2020-04-01;Região de Saúde Centro;Unidade Local de Saúde de Castelo Branco;14161;2687;410;0;17258
2020-04-01;Região de Saúde LVT;Centro Hospitalar do Oeste;31916;11539;2760;0;46215
2020-04-01;Região de Saúde LVT;Hospital de Loures;31818;14453;4949;0;51220
2020-04-01;Região de Saúde LVT;Hospital Distrital de Santarém;23425;8823;2223;0;34471
2020-04-01;Região de Saúde Norte;Centro Hospitalar do Médio Ave;24921;7667;1819;0;34407
2020-04-01;Região de Saúde Norte;Centro Hospitalar Póvoa de Varzim/Vila do Conde;19330;0;0;0;19330
2020-04-01;Região de Saúde Norte;Hospital de Braga;39787;11540;4328;0;55655
2020-04-01;Região de Saúde Norte;Unidade Local de Saúde do Nordeste;28955;0;0;0;28955
2020-05-01;Região de Saúde Alentejo;Unidade Local de Saúde do Baixo Alentejo;27733;4565;1573;0;33871
2020-05-01;Região de Saúde Alentejo;Unidade Local de Saúde do Norte Alentejano;25207;2587;481;0;28275
2020-05-01;Região de Saúde Algarve;Centro Hospitalar Universitário do Algarve;81170;20763;7179;0;109112
2020-05-01;Região de Saúde Centro;Centro Hospitalar Universitário Cova da Beira;16052;3834;1207;0;21093
2020-05-01;Região de Saúde Centro;Centro Hospitalar e Universitário de Coimbra;63534;18493;8548;0;90575
2020-05-01;Região de Saúde Centro;Unidade Local de Saúde da Guarda;23966;4295;1687;0;29948
2020-05-01;Região de Saúde LVT;Hospital de Loures;38681;15774;5911;0;60366
2020-05-01;Região de Saúde Norte;Centro Hospitalar Universitário de São João;57790;21526;4442;0;83758
2020-05-01;Região de Saúde Norte;Centro Hospitalar Póvoa de Varzim/Vila do Conde;22995;0;0;0;22995
2020-05-01;Região de Saúde Norte;Centro Hospitalar Tâmega e Sousa;51502;10685;5020;0;67207
2020-05-01;Região de Saúde Norte;Centro Hospitalar Vila Nova de Gaia/Espinho;43489;10793;4101;0;58383
2020-05-01;Região de Saúde Norte;Hospital da Senhora da Oliveira;31396;7687;3345;0;42428
2020-05-01;Região de Saúde Norte;Unidade Local de Saúde do Nordeste;34542;0;0;0;34542
2020-06-01;Região de Saúde Alentejo;Unidade Local de Saúde do Norte Alentejano;29574;2841;624;0;33039
2020-06-01;Região de Saúde Centro;Centro Hospitalar do Baixo Vouga;47971;10108;2864;0;60943
2020-06-01;Região de Saúde LVT;Centro Hospitalar Universitário de Lisboa Norte;67144;14045;6855;0;88044
2020-06-01;Região de Saúde LVT;Hospital de Loures;44897;17051;6732;0;68680
2020-06-01;Região de Saúde LVT;Hospital Professor Doutor Fernando Fonseca;69675;16507;8149;0;94331
2020-06-01;Região de Saúde LVT;Hospital Garcia de Orta;41499;9536;7216;0;58251
2020-06-01;Região de Saúde Norte;Centro Hospitalar Universitário de São João;69052;24304;5366;0;98722
2020-06-01;Região de Saúde Norte;Hospital de Braga;59026;14473;6197;0;79696
2020-06-01;Região de Saúde Norte;Unidade Local de Saúde de Matosinhos;33573;0;4059;0;37632
2020-07-01;Região de Saúde Alentejo;Unidade Local de Saúde do Litoral Alentejano;40219;0;0;0;40219
2020-07-01;Região de Saúde Algarve;Centro Hospitalar Universitário do Algarve;114132;26075;10275;0;150482
2020-07-01;Região de Saúde LVT;Centro Hospitalar de Lisboa Ocidental;50392;10819;6889;0;68100
2020-07-01;Região de Saúde LVT;Hospital de Vila Franca de Xira;41516;15686;4941;0;62143
2020-07-01;Região de Saúde Norte;Centro Hospitalar Tâmega e Sousa;72908;13122;7389;0;93419
2020-07-01;Região de Saúde Norte;Hospital Santa Maria Maior;22789;4397;0;0;27186
2020-08-01;Região de Saúde Alentejo;Unidade Local de Saúde do Litoral Alentejano;46942;0;0;0;46942
2020-08-01;Região de Saúde Alentejo;Unidade Local de Saúde do Norte Alentejano;39876;3501;952;0;44329
2020-08-01;Região de Saúde LVT;Centro Hospitalar Universitário de Lisboa Norte;88791;17364;9318;0;115473
2020-08-01;Região de Saúde LVT;Centro Hospitalar Médio Tejo;57731;10038;2439;0;70208
2020-08-01;Região de Saúde Norte;Centro Hospitalar Universitário de São João;94651;31711;7341;0;133703
2020-08-01;Região de Saúde Norte;Centro Hospitalar Tâmega e Sousa;84504;14569;8592;0;107665
2020-08-01;Região de Saúde Norte;Hospital de Braga;82285;18582;8321;0;109188
2020-09-01;Região de Saúde Alentejo;Unidade Local de Saúde do Baixo Alentejo;47434;6766;2516;0;56716
2020-09-01;Região de Saúde Centro;Unidade Local de Saúde da Guarda;44760;6481;2989;0;54230
2020-09-01;Região de Saúde LVT;Hospital Distrital de Santarém;48554;13314;5142;0;67010
2020-09-01;Região de Saúde Norte;Centro Hospitalar Entre Douro e Vouga;96611;12377;5126;0;114114
2020-09-01;Região de Saúde Norte;Centro Hospitalar Póvoa de Varzim/Vila do Conde;40125;0;0;0;40125
2020-10-01;Região de Saúde Algarve;Centro Hospitalar Universitário do Algarve;167168;36615;15022;0;218805
2020-10-01;Região de Saúde LVT;Centro Hospitalar de Lisboa Ocidental;70874;15275;10039;0;96188
2020-10-01;Região de Saúde Norte;Unidade Local de Saúde de Matosinhos;58127;0;6822;0;64949
2020-11-01;Região de Saúde Algarve;Centro Hospitalar Universitário do Algarve;180428;39566;16362;0;236356
2020-11-01;Região de Saúde Centro;Centro Hospitalar e Universitário de Coimbra;138910;36986;19121;0;195017
2020-11-01;Região de Saúde Centro;Hospital Distrital da Figueira da Foz;39132;9275;0;0;48407
2020-11-01;Região de Saúde Centro;Unidade Local de Saúde de Castelo Branco;37061;5298;1254;0;43613
2020-11-01;Região de Saúde LVT;Centro Hospitalar Universitário Lisboa Central;93469;43891;15761;5068;158189
2020-11-01;Região de Saúde LVT;Hospital de Vila Franca de Xira;62932;22863;7660;0;93455
2020-11-01;Região de Saúde Norte;Centro Hospitalar Universitário de São João;133149;45893;10106;0;189148
2020-11-01;Região de Saúde Norte;Centro Hospitalar do Médio Ave;67990;15761;5189;0;88940
2020-11-01;Região de Saúde Norte;Centro Hospitalar Entre Douro e Vouga;116737;14890;6236;0;137863
2020-11-01;Região de Saúde Norte;Hospital da Senhora da Oliveira;70786;13785;7720;0;92291
2020-12-01;Região de Saúde Alentejo;Hospital Espírito Santo de Évora;43177;10738;0;0;53915
2020-12-01;Região de Saúde Alentejo;Unidade Local de Saúde do Baixo Alentejo;61080;8875;3193;0;73148
2020-12-01;Região de Saúde Centro;Centro Hospitalar e Universitário de Coimbra;150795;39567;20835;0;211197
2020-12-01;Região de Saúde LVT;Hospital de Loures;84232;28803;12757;0;125792
2020-12-01;Região de Saúde LVT;Hospital Professor Doutor Fernando Fonseca;136672;29456;15615;0;181743
2020-12-01;Região de Saúde Norte;Centro Hospitalar do Médio Ave;73819;16765;5562;0;96146
2020-12-01;Região de Saúde Norte;Centro Hospitalar Entre Douro e Vouga;125994;15827;6732;0;148553
2020-12-01;Região de Saúde Norte;Centro Hospitalar Póvoa de Varzim/Vila do Conde;53343;0;0;0;53343
2020-12-01;Região de Saúde Norte;Hospital de Braga;122956;26976;12060;0;161992
2020-12-01;Região de Saúde Norte;Unidade Local de Saúde do Alto Minho;95260;9863;4993;0;110116
2021-01-01;Região de Saúde Alentejo;Unidade Local de Saúde do Litoral Alentejano;4810;0;0;0;4810
2021-01-01;Região de Saúde Centro;Unidade Local de Saúde de Castelo Branco;2858;332;100;0;3290
2021-01-01;Região de Saúde LVT;Centro Hospitalar Médio Tejo;6480;916;211;0;7607
2021-01-01;Região de Saúde LVT;Hospital de Cascais;4354;1645;722;0;6721
2021-01-01;Região de Saúde LVT;Hospital de Vila Franca de Xira;5140;1424;498;0;7062
2021-01-01;Região de Saúde Norte;Centro Hospitalar Trás-os-Montes e Alto Douro;8789;842;531;0;10162
2021-02-01;Região de Saúde Centro;Unidade Local de Saúde da Guarda;7683;1492;497;0;9672
2021-02-01;Região de Saúde LVT;Hospital de Cascais;7912;2447;1372;0;11731
2021-02-01;Região de Saúde Norte;Centro Hospitalar Póvoa de Varzim/Vila do Conde;6952;0;0;0;6952
2021-02-01;Região de Saúde Norte;Centro Hospitalar Tâmega e Sousa;16357;2078;1639;0;20074
2021-03-01;Região de Saúde Centro;Centro Hospitalar de Leiria;21340;2577;2144;0;26061
2021-03-01;Região de Saúde Centro;Centro Hospitalar do Baixo Vouga;20591;3063;1361;0;25015
2021-03-01;Região de Saúde Centro;Centro Hospitalar Tondela-Viseu;19663;2672;2827;0;25162
2021-03-01;Região de Saúde LVT;Centro Hospitalar Universitário Lisboa Central;21343;8056;3740;1090;34229
2021-03-01;Região de Saúde LVT;Centro Hospitalar do Oeste;16604;2854;1674;0;21132
2021-03-01;Região de Saúde LVT;Hospital Garcia de Orta;16013;2730;2893;0;21636
2021-03-01;Região de Saúde Norte;Centro Hospitalar Universitário de São João;30351;7931;2490;0;40772
2021-03-01;Região de Saúde Norte;Centro Hospitalar Entre Douro e Vouga;26617;2315;1533;0;30465
2021-03-01;Região de Saúde Norte;Unidade Local de Saúde de Matosinhos;14184;0;1836;0;16020
2021-04-01;Região de Saúde LVT;Centro Hospitalar Barreiro/Montijo;23271;4705;2247;0;30223
2021-04-01;Região de Saúde LVT;Centro Hospitalar Universitário Lisboa Central;29585;12619;5140;1623;48967
2021-04-01;Região de Saúde LVT;Centro Hospitalar de Lisboa Ocidental;22084;4573;3439;0;30096
2021-04-01;Região de Saúde LVT;Centro Hospitalar de Setúbal;20984;5116;2961;0;29061
2021-04-01;Região de Saúde LVT;Hospital de Vila Franca de Xira;19862;5437;2177;0;27476
2021-04-01;Região de Saúde Norte;Centro Hospitalar Universitário do Porto;29844;0;5361;0;35205
2021-04-01;Região de Saúde Norte;Hospital Santa Maria Maior;12139;1147;0;0;13286
2021-05-01;Região de Saúde Alentejo;Hospital Espírito Santo de Évora;16863;3592;0;0;20455
2021-05-01;Região de Saúde Alentejo;Unidade Local de Saúde do Norte Alentejano;21835;1557;519;0;23911
2021-05-01;Região de Saúde Norte;Centro Hospitalar Entre Douro e Vouga;50026;5408;2794;0;58228
2021-05-01;Região de Saúde Norte;Centro Hospitalar Tâmega e Sousa;49317;7981;4717;0;62015
2021-05-01;Região de Saúde Norte;Hospital da Senhora da Oliveira;31284;5053;3229;0;39566
2021-05-01;Região de Saúde Norte;Unidade Local de Saúde do Nordeste;29158;0;0;0;29158
2021-06-01;Região de Saúde Alentejo;Unidade Local de Saúde do Norte Alentejano;27573;2080;637;0;30290
2021-06-01;Região de Saúde Centro;Centro Hospitalar Tondela-Viseu;44794;8982;6293;0;60069
2021-06-01;Região de Saúde LVT;Hospital Distrital de Santarém;31637;7068;3168;0;41873
2021-06-01;Região de Saúde LVT;Hospital Professor Doutor Fernando Fonseca;69169;16089;7605;0;92863
2021-06-01;Região de Saúde Norte;Centro Hospitalar Vila Nova de Gaia/Espinho;54055;12118;4789;0;70962
2021-06-01;Região de Saúde Norte;Hospital de Braga;62369;13794;5637;0;81800
2021-06-01;Região de Saúde Norte;Unidade Local de Saúde do Alto Minho;46872;4207;2381;0;53460
2021-07-01;Região de Saúde Alentejo;Unidade Local de Saúde do Litoral Alentejano;38944;0;0;0;38944
2021-07-01;Região de Saúde Alentejo;Unidade Local de Saúde do Norte Alentejano;33433;2608;761;0;36802
2021-07-01;Região de Saúde Centro;Centro Hospitalar do Baixo Vouga;60117;14054;3502;0;77673
2021-07-01;Região de Saúde Centro;Centro Hospitalar Tondela-Viseu;54147;11261;7482;0;72890
2021-07-01;Região de Saúde Centro;Unidade Local de Saúde de Castelo Branco;22734;4272;720;0;27726
2021-07-01;Região de Saúde LVT;Centro Hospitalar Universitário de Lisboa Norte;68777;14996;8717;0;92490
2021-07-01;Região de Saúde LVT;Hospital de Loures;48240;17721;7266;0;73227
2021-07-01;Região de Saúde LVT;Hospital de Vila Franca de Xira;40433;15122;4282;0;59837
2021-07-01;Região de Saúde Norte;Centro Hospitalar do Médio Ave;43587;10638;3275;0;57500
2021-07-01;Região de Saúde Norte;Hospital da Senhora da Oliveira;47303;10338;4765;0;62406
2021-07-01;Região de Saúde Norte;Hospital de Braga;75301;17160;6750;0;99211
2021-08-01;Região de Saúde Centro;Hospital Distrital da Figueira da Foz;30848;7605;0;0;38453
2021-08-01;Região de Saúde LVT;Centro Hospitalar de Setúbal;48580;16192;6523;0;71295
2021-08-01;Região de Saúde LVT;Centro Hospitalar Universitário de Lisboa Norte;81061;17228;10199;0;108488
2021-08-01;Região de Saúde LVT;Centro Hospitalar Médio Tejo;60395;11153;2258;0;73806
2021-08-01;Região de Saúde Norte;Centro Hospitalar Entre Douro e Vouga;91338;12514;4929;0;108781
2021-08-01;Região de Saúde Norte;Centro Hospitalar Tâmega e Sousa;88619;16327;8415;0;113361
2021-08-01;Região de Saúde Norte;Centro Hospitalar Trás-os-Montes e Alto Douro;80234;10425;4647;0;95306
2021-08-01;Região de Saúde Norte;Centro Hospitalar Vila Nova de Gaia/Espinho;77068;17649;6761;0;101478
2021-08-01;Região de Saúde Norte;Hospital de Braga;88800;20114;7981;0;116895
2021-08-01;Região de Saúde Norte;Unidade Local de Saúde do Alto Minho;69648;6671;3331;0;79650
2021-09-01;Região de Saúde Norte;Centro Hospitalar Universitário de São João;115145;43011;8810;0;166966
2021-09-01;Região de Saúde Norte;Centro Hospitalar Universitário do Porto;81627;0;13971;0;95598
2021-09-01;Região de Saúde Norte;Centro Hospitalar Tâmega e Sousa;100899;19100;9615;0;129614
2021-09-01;Região de Saúde Norte;Hospital Santa Maria Maior;33017;5039;0;0;38056
2021-09-01;Região de Saúde Norte;Unidade Local de Saúde do Alto Minho;80027;7740;3777;0;91544
2021-10-01;Região de Saúde LVT;Centro Hospitalar Universitário Lisboa Central;92791;50543;14771;4848;162953
2021-10-01;Região de Saúde Norte;Centro Hospitalar Universitário de São João;129635;51563;10011;0;191209
2021-10-01;Região de Saúde Norte;Centro Hospitalar do Médio Ave;65677;17523;4878;0;88078
2021-10-01;Região de Saúde Norte;Centro Hospitalar Entre Douro e Vouga;119310;18690;6356;0;144356
2021-11-01;Região de Saúde Alentejo;Unidade Local de Saúde do Norte Alentejano;56926;5170;1360;0;63456
2021-11-01;Região de Saúde Centro;Centro Hospitalar do Baixo Vouga;102067;27505;5649;0;135221
2021-11-01;Região de Saúde Centro;Centro Hospitalar Tondela-Viseu;90776;21640;12395;0;124811
2021-11-01;Região de Saúde Centro;Unidade Local de Saúde de Castelo Branco;38691;8404;1247;0;48342
2021-11-01;Região de Saúde LVT;Centro Hospitalar do Oeste;89083;28761;7181;0;125025
2021-11-01;Região de Saúde LVT;Hospital de Cascais;68243;33668;9980;0;111891
2021-11-01;Região de Saúde LVT;Hospital Distrital de Santarém;65682;18533;6254;0;90469
2021-11-01;Região de Saúde Norte;Unidade Local de Saúde de Matosinhos;68756;0;8386;0;77142
2021-12-01;Região de Saúde Centro;Centro Hospitalar Tondela-Viseu;98781;23752;13586;0;136119
2021-12-01;Região de Saúde LVT;Centro Hospitalar Barreiro/Montijo;85742;27252;8325;0;121319
2021-12-01;Região de Saúde LVT;Centro Hospitalar Universitário de Lisboa Norte;131423;31289;15887;0;178599
2021-12-01;Região de Saúde Norte;Centro Hospitalar do Médio Ave;80070;22975;5920;0;108965
2021-12-01;Região de Saúde Norte;Centro Hospitalar Tâmega e Sousa;137974;30933;13106;0;182013
2021-12-01;Região de Saúde Norte;Hospital de Braga;137651;35812;12267;0;185730
2021-12-01;Região de Saúde Norte;Unidade Local de Saúde do Nordeste;87101;0;0;0;87101
2022-01-01;Região de Saúde Alentejo;Hospital Espírito Santo de Évora;4240;1255;0;0;5495
2022-01-01;Região de Saúde Alentejo;Unidade Local de Saúde do Norte Alentejano;5231;580;202;0;6013
2022-01-01;Região de Saúde Centro;Centro Hospitalar e Universitário de Coimbra;13434;4208;1766;0;19408
2022-01-01;Região de Saúde LVT;Hospital Professor Doutor Fernando Fonseca;13296;3527;1486;0;18309
2022-01-01;Região de Saúde Norte;Hospital da Senhora da Oliveira;8046;1985;787;0;10818
2022-01-01;Região de Saúde Norte;Hospital Santa Maria Maior;4053;736;0;0;4789
2022-02-01;Região de Saúde Centro;Hospital Distrital da Figueira da Foz;7628;2314;0;0;9942
2022-02-01;Região de Saúde Centro;Unidade Local de Saúde de Castelo Branco;7140;1619;222;0;8981
2022-02-01;Região de Saúde LVT;Centro Hospitalar Universitário Lisboa Central;20174;11446;2892;975;35487
2022-02-01;Região de Saúde LVT;Hospital de Loures;14988;7050;2189;0;24227
2022-02-01;Região de Saúde Norte;Centro Hospitalar Trás-os-Montes e Alto Douro;20904;3677;1155;0;25736
2022-02-01;Região de Saúde Norte;Unidade Local de Saúde de Matosinhos;12710;0;1433;0;14143
2022-02-01;Região de Saúde Norte;Unidade Local de Saúde do Alto Minho;18707;2120;783;0;21610
2022-03-01;Região de Saúde Centro;Centro Hospitalar Tondela-Viseu;25804;7795;3525;0;37124
2022-03-01;Região de Saúde Centro;Unidade Local de Saúde de Castelo Branco;11497;3131;383;0;15011
2022-03-01;Região de Saúde LVT;Centro Hospitalar Universitário Lisboa Central;31762;20572;4533;1500;58367
2022-03-01;Região de Saúde LVT;Centro Hospitalar do Oeste;27268;10992;2036;0;40296
2022-03-01;Região de Saúde LVT;Hospital Distrital de Santarém;19762;6620;1866;0;28248
2022-03-01;Região de Saúde LVT;Hospital Professor Doutor Fernando Fonseca;39735;14227;4538;0;58500
2022-03-01;Região de Saúde LVT;Hospital Garcia de Orta;22117;10968;4108;0;37193
2022-03-01;Região de Saúde Norte;Hospital da Senhora da Oliveira;24195;8372;2287;0;34854
2022-03-01;Região de Saúde Norte;Hospital Santa Maria Maior;12193;3035;0;0;15228
2022-03-01;Região de Saúde Norte;Unidade Local de Saúde do Alto Minho;29994;4071;1336;0;35401
2022-04-01;Região de Saúde Centro;Centro Hospitalar Universitário Cova da Beira;15197;4393;1109;56;20755
2022-04-01;Região de Saúde Centro;Centro Hospitalar do Baixo Vouga;40694;13383;1955;0;56032
2022-04-01;Região de Saúde Centro;Unidade Local de Saúde de Castelo Branco;15714;4406;515;0;20635
2022-04-01;Região de Saúde LVT;Centro Hospitalar Barreiro/Montijo;32810;12672;3136;0;48618
2022-04-01;Região de Saúde LVT;Centro Hospitalar Universitário de Lisboa Norte;48308;13480;5713;0;67501
2022-04-01;Região de Saúde LVT;Hospital de Loures;31106;17161;4248;0;52515
2022-04-01;Região de Saúde LVT;Hospital Professor Doutor Fernando Fonseca;53463;19296;6060;0;78819
2022-04-01;Região de Saúde Norte;Centro Hospitalar Entre Douro e Vouga;56574;11299;2837;0;70710
2022-04-01;Região de Saúde Norte;Centro Hospitalar Póvoa de Varzim/Vila do Conde;23023;0;0;0;23023
2022-04-01;Região de Saúde Norte;Unidade Local de Saúde do Alto Minho;41534;5617;1629;0;48780
2022-05-01;Região de Saúde Centro;Centro Hospitalar de Leiria;54657;13667;4712;0;73036
2022-05-01;Região de Saúde LVT;Centro Hospitalar Universitário Lisboa Central;55413;35264;7919;2648;101244
2022-05-01;Região de Saúde LVT;Centro Hospitalar de Lisboa Ocidental;40403;16042;6074;0;62519
2022-05-01;Região de Saúde LVT;Hospital de Cascais;36137;22298;5159;0;63594
2022-05-01;Região de Saúde LVT;Hospital Distrital de Santarém;34744;12562;3180;0;50486
2022-05-01;Região de Saúde LVT;Hospital Garcia de Orta;36445;19784;6800;0;63029
2022-05-01;Região de Saúde Norte;Centro Hospitalar Universitário do Porto;51696;0;8426;0;60122
2022-05-01;Região de Saúde Norte;Centro Hospitalar Trás-os-Montes e Alto Douro;59371;12529;3077;0;74977
2022-06-01;Região de Saúde Alentejo;Unidade Local de Saúde do Baixo Alentejo;39739;9753;1841;0;51333
2022-06-01;Região de Saúde Algarve;Centro Hospitalar Universitário do Algarve;130934;35145;9741;0;175820
2022-06-01;Região de Saúde Centro;Centro Hospitalar de Leiria;66403;16459;5691;0;88553
2022-06-01;Região de Saúde Centro;Centro Hospitalar do Baixo Vouga;63769;20913;3121;0;87803
2022-06-01;Região de Saúde Centro;Centro Hospitalar e Universitário de Coimbra;89944;34827;10840;0;135611
2022-06-01;Região de Saúde LVT;Hospital de Cascais;43837;26061;6208;0;76106
2022-06-01;Região de Saúde Norte;Centro Hospitalar do Médio Ave;44959;15827;3203;0;63989
2022-06-01;Região de Saúde Norte;Centro Hospitalar Póvoa de Varzim/Vila do Conde;36205;0;0;0;36205
2022-06-01;Região de Saúde Norte;Centro Hospitalar Tâmega e Sousa;76099;19895;7036;0;103030
2022-06-01;Região de Saúde Norte;Unidade Local de Saúde do Alto Minho;64339;9114;2810;0;76263
2022-07-01;Região de Saúde Centro;Centro Hospitalar e Universitário de Coimbra;105316;39993;12840;0;158149
2022-07-01;Região de Saúde Centro;Centro Hospitalar Tondela-Viseu;63459;19571;8514;0;91544
2022-07-01;Região de Saúde Centro;Unidade Local de Saúde da Guarda;42704;8228;2318;0;53250
2022-07-01;Região de Saúde LVT;Hospital de Vila Franca de Xira;46663;25981;4891;0;77535
2022-07-01;Região de Saúde Norte;Centro Hospitalar Universitário de São João;97896;47695;7446;0;153037
2022-07-01;Região de Saúde Norte;Centro Hospitalar Trás-os-Montes e Alto Douro;84639;16593;4438;0;105670
2022-07-01;Região de Saúde Norte;Hospital de Braga;84601;25426;7422;0;117449
2022-08-01;Região de Saúde Alentejo;Hospital Espírito Santo de Évora;35742;13245;0;0;48987
2022-08-01;Região de Saúde Centro;Centro Hospitalar Universitário Cova da Beira;31731;8745;2437;348;43261
2022-08-01;Região de Saúde LVT;Hospital Professor Doutor Fernando Fonseca;113375;36994;12753;0;163122
2022-08-01;Região de Saúde Norte;Unidade Local de Saúde de Matosinhos;56348;0;6333;0;62681
2022-08-01;Região de Saúde Norte;Unidade Local de Saúde do Alto Minho;90269;12064;3996;0;106329
2022-09-01;Região de Saúde Centro;Centro Hospitalar Universitário Cova da Beira;35593;9614;2811;379;48397
2022-09-01;Região de Saúde Centro;Centro Hospitalar do Baixo Vouga;96388;29230;4727;0;130345
2022-09-01;Região de Saúde Centro;Unidade Local de Saúde da Guarda;55837;10233;3039;0;69109
2022-09-01;Região de Saúde LVT;Centro Hospitalar do Oeste;85014;32513;6292;0;123819
2022-09-01;Região de Saúde LVT;Centro Hospitalar Médio Tejo;85708;22178;2955;0;110841
2022-09-01;Região de Saúde LVT;Hospital de Cascais;66981;36753;9728;0;113462
2022-09-01;Região de Saúde Norte;Centro Hospitalar Tâmega e Sousa;113647;27473;10757;0;151877
2022-09-01;Região de Saúde Norte;Unidade Local de Saúde do Alto Minho;101434;13336;4543;0;119313
2022-10-01;Região de Saúde Algarve;Centro Hospitalar Universitário do Algarve;235495;59759;17033;0;312287
2022-10-01;Região de Saúde Centro;Centro Hospitalar de Leiria;113315;27273;9967;0;150555
2022-10-01;Região de Saúde Centro;Centro Hospitalar Tondela-Viseu;91434;27970;12703;0;132107
2022-10-01;Região de Saúde Centro;Unidade Local de Saúde de Castelo Branco;41308;11155;1348;0;53811
2022-10-01;Região de Saúde LVT;Centro Hospitalar de Lisboa Ocidental;80114;28688;11961;0;120763
2022-10-01;Região de Saúde LVT;Centro Hospitalar Médio Tejo;95907;26125;3268;0;125300
2022-10-01;Região de Saúde Norte;Centro Hospitalar do Médio Ave;74709;25796;5587;0;106092
2022-10-01;Região de Saúde Norte;Centro Hospitalar Vila Nova de Gaia/Espinho;112608;36764;6856;0;156228
2022-10-01;Região de Saúde Norte;Hospital de Braga;121201;36085;10746;0;168032
2022-10-01;Região de Saúde Norte;Hospital Santa Maria Maior;43644;10934;0;0;54578
2022-11-01;Região de Saúde Algarve;Centro Hospitalar Universitário do Algarve;258294;67360;18685;0;344339
2022-11-01;Região de Saúde Centro;Centro Hospitalar de Leiria;124640;31541;10921;0;167102
2022-11-01;Região de Saúde LVT;Centro Hospitalar Barreiro/Montijo;96690;35943;9125;0;141758
2022-11-01;Região de Saúde LVT;Centro Hospitalar de Lisboa Ocidental;87954;32966;13067;0;133987
2022-11-01;Região de Saúde LVT;Hospital de Cascais;82335;48271;11861;0;142467
2022-11-01;Região de Saúde LVT;Hospital de Loures;85512;49444;12029;0;146985
2022-11-01;Região de Saúde LVT;Hospital Distrital de Santarém;77030;29752;7292;0;114074
2022-11-01;Região de Saúde LVT;Hospital Professor Doutor Fernando Fonseca;159477;55484;18292;0;233253
2022-11-01;Região de Saúde Norte;Centro Hospitalar Universitário do Porto;115673;0;19379;0;135052
2022-11-01;Região de Saúde Norte;Centro Hospitalar Entre Douro e Vouga;166519;33773;8361;0;208653
2022-12-01;Região de Saúde Alentejo;Hospital Espírito Santo de Évora;53656;20349;0;0;74005
2022-12-01;Região de Saúde Alentejo;Unidade Local de Saúde do Litoral Alentejano;95669;0;0;0;95669
2022-12-01;Região de Saúde LVT;Centro Hospitalar Universitário Lisboa Central;135837;83262;20147;6491;245737
2022-12-01;Região de Saúde LVT;Centro Hospitalar Médio Tejo;115927;34288;3923;0;154138
2022-12-01;Região de Saúde LVT;Hospital de Loures;91953;54208;13022;0;159183
2022-12-01;Região de Saúde LVT;Hospital Professor Doutor Fernando Fonseca;173943;60877;19943;0;254763
2022-12-01;Região de Saúde Norte;Centro Hospitalar Universitário do Porto;125270;0;21113;0;146383
2022-12-01;Região de Saúde Norte;Centro Hospitalar Póvoa de Varzim/Vila do Conde;73960;0;0;0;73960
2022-12-01;Região de Saúde Norte;Hospital da Senhora da Oliveira;100865;35750;10257;0;146872
2023-01-01;Região de Saúde Centro;Centro Hospitalar do Baixo Vouga;10641;3388;526;0;14555
2023-01-01;Região de Saúde LVT;Centro Hospitalar Universitário Lisboa Central;11098;6940;1773;463;20274
2023-01-01;Região de Saúde LVT;Centro Hospitalar Médio Tejo;9848;2996;273;0;13117
2023-01-01;Região de Saúde Norte;Centro Hospitalar Universitário de São João;14226;6419;1040;0;21685
2023-01-01;Região de Saúde Norte;Centro Hospitalar do Médio Ave;7324;2788;586;0;10698
2023-01-01;Região de Saúde Norte;Centro Hospitalar Universitário do Porto;10201;0;1626;0;11827
2023-01-01;Região de Saúde Norte;Unidade Local de Saúde do Nordeste;8691;0;0;0;8691
2023-02-01;Região de Saúde Alentejo;Hospital Espírito Santo de Évora;8573;3031;0;0;11604
2023-02-01;Região de Saúde Centro;Centro Hospitalar Universitário Cova da Beira;7945;2604;643;43;11235
2023-02-01;Região de Saúde Centro;Centro Hospitalar do Baixo Vouga;20746;6744;1005;0;28495
2023-02-01;Região de Saúde Centro;Hospital Distrital da Figueira da Foz;8087;3160;0;0;11247
2023-02-01;Região de Saúde Centro;Unidade Local de Saúde da Guarda;12706;2750;676;0;16132
2023-02-01;Região de Saúde LVT;Centro Hospitalar Barreiro/Montijo;18636;7058;1517;0;27211
2023-02-01;Região de Saúde LVT;Centro Hospitalar Médio Tejo;18907;6007;550;0;25464
2023-02-01;Região de Saúde LVT;Hospital Distrital de Santarém;13157;5214;1237;0;19608
2023-02-01;Região de Saúde Norte;Centro Hospitalar Tâmega e Sousa;24537;6247;2230;0;33014
2023-02-01;Região de Saúde Norte;Centro Hospitalar Universitário de Santo António;19937;0;3122;0;23059
2023-02-01;Região de Saúde Norte;Hospital da Senhora da Oliveira;16797;5799;1588;0;24184
2023-03-01;Região de Saúde Alentejo;Hospital Espírito Santo de Évora;12808;4637;0;0;17445
2023-03-01;Região de Saúde Alentejo;Unidade Local de Saúde do Baixo Alentejo;23191;4503;932;0;28626
2023-03-01;Região de Saúde Alentejo;Unidade Local de Saúde do Norte Alentejano;19264;2252;561;0;22077
2023-03-01;Região de Saúde Centro;Unidade Local de Saúde da Guarda;19372;4177;969;0;24518
2023-03-01;Região de Saúde Centro;Unidade Local de Saúde de Castelo Branco;12901;3847;400;0;17148
2023-03-01;Região de Saúde LVT;Centro Hospitalar de Lisboa Ocidental;22981;8735;3160;0;34876
2023-03-01;Região de Saúde LVT;Centro Hospitalar Universitário de Lisboa Norte;33992;11054;4347;0;49393
2023-03-01;Região de Saúde LVT;Hospital de Cascais;22084;12812;3199;0;38095
2023-03-01;Região de Saúde Norte;Centro Hospitalar Trás-os-Montes e Alto Douro;36996;8197;1898;0;47091
2023-04-01;Região de Saúde Alentejo;Hospital Espírito Santo de Évora;16862;6031;0;0;22893
2023-04-01;Região de Saúde Alentejo;Unidade Local de Saúde do Baixo Alentejo;30289;5851;1279;0;37419
2023-04-01;Região de Saúde Algarve;Centro Hospitalar Universitário do Algarve;90106;23419;6149;0;119674
2023-04-01;Região de Saúde LVT;Centro Hospitalar do Oeste;37641;16213;2358;0;56212
2023-04-01;Região de Saúde LVT;Centro Hospitalar Universitário de Lisboa Norte;45448;15188;5746;0;66382
2023-04-01;Região de Saúde Norte;Centro Hospitalar do Médio Ave;28588;11127;2247;0;41962
2023-04-01;Região de Saúde Norte;Centro Hospitalar Entre Douro e Vouga;61081;12141;2743;0;75965
2023-04-01;Região de Saúde Norte;Centro Hospitalar Trás-os-Montes e Alto Douro;49073;10429;2598;0;62100
2023-04-01;Região de Saúde Norte;Unidade Local de Saúde de Matosinhos;26543;0;3046;0;29589
2023-05-01;Região de Saúde Alentejo;Unidade Local de Saúde do Norte Alentejano;32220;3818;970;0;37008
2023-05-01;Região de Saúde Algarve;Centro Hospitalar Universitário do Algarve;114497;29474;7875;0;151846
2023-05-01;Região de Saúde LVT;Centro Hospitalar de Lisboa Ocidental;38631;14296;5474;0;58401
2023-05-01;Região de Saúde LVT;Centro Hospitalar de Setúbal;31699;15323;3832;0;50854
2023-05-01;Região de Saúde LVT;Centro Hospitalar do Oeste;47882;20505;3006;0;71393
2023-05-01;Região de Saúde Norte;Centro Hospitalar Universitário de São João;72664;34130;5307;0;112101
2023-05-01;Região de Saúde Norte;Centro Hospitalar do Médio Ave;36287;14138;2867;0;53292
2023-05-01;Região de Saúde Norte;Hospital de Braga;62020;20436;5652;0;88108
2023-06-01;Região de Saúde Centro;Centro Hospitalar e Universitário de Coimbra;90731;33129;10827;0;134687
2023-06-01;Região de Saúde LVT;Centro Hospitalar de Lisboa Ocidental;46474;16523;6473;0;69470
2023-06-01;Região de Saúde LVT;Hospital Garcia de Orta;42077;24380;8944;0;75401
2023-06-01;Região de Saúde Norte;Centro Hospitalar do Médio Ave;43592;16567;3466;0;63625
2023-07-01;Região de Saúde LVT;Centro Hospitalar de Lisboa Ocidental;54323;18590;7670;0;80583
2023-07-01;Região de Saúde LVT;Hospital de Cascais;52729;28606;7950;0;89285
2023-07-01;Região de Saúde Norte;Hospital Santa Maria Maior;31722;7560;0;0;39282
2023-07-01;Região de Saúde Norte;Unidade Local de Saúde do Nordeste;58237;0;0;0;58237
2023-08-01;Região de Saúde Alentejo;Hospital Espírito Santo de Évora;34827;11633;0;0;46460
2023-08-01;Região de Saúde Centro;Centro Hospitalar e Universitário de Coimbra;123167;42721;15117;0;181005
2023-08-01;Região de Saúde Centro;Centro Hospitalar Tondela-Viseu;76995;22628;10133;0;109756
2023-08-01;Região de Saúde Centro;Unidade Local de Saúde da Guarda;53805;10013;2876;0;66694
2023-08-01;Região de Saúde Centro;Unidade Local de Saúde de Castelo Branco;35914;10091;1200;0;47205
2023-08-01;Região de Saúde LVT;Centro Hospitalar de Setúbal;51287;22380;6688;0;80355
2023-08-01;Região de Saúde LVT;Centro Hospitalar Médio Tejo;79853;21507;3095;0;104455
2023-08-01;Região de Saúde Norte;Centro Hospitalar Tâmega e Sousa;105511;24333;10383;0;140227
2023-08-01;Região de Saúde Norte;Hospital da Senhora da Oliveira;70392;22428;7259;0;100079
2023-08-01;Região de Saúde Norte;Unidade Local de Saúde do Alto Minho;97490;13152;4572;0;115214
2023-09-01;Região de Saúde Alentejo;Unidade Local de Saúde do Litoral Alentejano;72931;0;0;0;72931
2023-09-01;Região de Saúde Centro;Centro Hospitalar Universitário Cova da Beira;37727;10738;3057;316;51838
2023-09-01;Região de Saúde Centro;Centro Hospitalar do Baixo Vouga;101202;30954;5332;0;137488
2023-09-01;Região de Saúde Centro;Hospital Distrital da Figueira da Foz;40111;13981;0;0;54092
2023-09-01;Região de Saúde Centro;Unidade Local de Saúde de Castelo Branco;39913;10962;1354;0;52229
2023-09-01;Região de Saúde LVT;Centro Hospitalar Barreiro/Montijo;86236;25954;7072;0;119262
2023-09-01;Região de Saúde LVT;Centro Hospitalar de Setúbal;57328;24601;7501;0;89430
2023-09-01;Região de Saúde LVT;Hospital de Loures;60600;23240;10464;0;94304
2023-09-01;Região de Saúde Norte;Centro Hospitalar Universitário de Santo António;97289;0;15279;0;112568
2023-09-01;Região de Saúde Norte;Hospital Santa Maria Maior;41245;9071;0;0;50316
2023-10-01;Região de Saúde Centro;Centro Hospitalar e Universitário de Coimbra;153526;52923;19256;0;225705
2023-10-01;Região de Saúde LVT;Centro Hospitalar Barreiro/Montijo;95564;28666;7735;0;131965
2023-10-01;Região de Saúde LVT;Centro Hospitalar Universitário Lisboa Central;114171;64816;20077;5315;204379
2023-10-01;Região de Saúde LVT;Centro Hospitalar de Lisboa Ocidental;77267;24910;13580;0;115757
2023-10-01;Região de Saúde LVT;Centro Hospitalar Médio Tejo;99268;25666;4028;0;128962
2023-10-01;Região de Saúde LVT;Hospital Professor Doutor Fernando Fonseca;146745;47289;17133;0;211167
2023-10-01;Região de Saúde Norte;Centro Hospitalar Póvoa de Varzim/Vila do Conde;59140;0;0;0;59140
2023-10-01;Região de Saúde Norte;Centro Hospitalar Tâmega e Sousa;130386;29887;13016;0;173289
2023-10-01;Região de Saúde Norte;Unidade Local de Saúde de Matosinhos;70178;0;7946;0;78124
2023-11-01;Região de Saúde Alentejo;Hospital Espírito Santo de Évora;47369;15648;0;0;63017
2023-11-01;Região de Saúde Alentejo;Unidade Local de Saúde do Baixo Alentejo;82577;16055;3888;0;102520
2023-11-01;Região de Saúde Alentejo;Unidade Local de Saúde do Litoral Alentejano;88364;0;0;0;88364
2023-11-01;Região de Saúde Centro;Centro Hospitalar do Baixo Vouga;121072;38680;6451;0;166203
2023-11-01;Região de Saúde Centro;Centro Hospitalar Tondela-Viseu;104938;31320;13740;0;149998
2023-11-01;Região de Saúde Centro;Unidade Local de Saúde de Castelo Branco;48202;13723;1689;0;63614
2023-11-01;Região de Saúde LVT;Centro Hospitalar Universitário Lisboa Central;124984;73345;22213;5838;226380
2023-11-01;Região de Saúde LVT;Hospital Professor Doutor Fernando Fonseca;160577;51710;17970;0;230257
2023-11-01;Região de Saúde Norte;Centro Hospitalar Entre Douro e Vouga;169170;31972;8047;0;209189
2023-11-01;Região de Saúde Norte;Centro Hospitalar Póvoa de Varzim/Vila do Conde;65490;0;0;0;65490
2023-12-01;Região de Saúde LVT;Hospital de Cascais;88370;48908;15263;0;152541
2023-12-01;Região de Saúde LVT;Hospital Distrital de Santarém;79915;32662;7624;0;120201
2023-12-01;Região de Saúde Norte;Centro Hospitalar Universitário de Santo António;127285;0;20472;0;147757
2023-12-01;Região de Saúde Norte;Centro Hospitalar Vila Nova de Gaia/Espinho;140711;47312;8624;0;196647
2023-12-01;Região de Saúde Norte;Hospital Santa Maria Maior;53500;13092;0;0;66592
2019-01-01;Região de Saúde Alentejo;Unidade Local de Saúde do Baixo Alentejo;8504;1881;308;0;10693
2019-01-01;Região de Saúde Centro;Centro Hospitalar Tondela-Viseu;9599;3591;1309;0;14499
2019-01-01;Região de Saúde LVT;Centro Hospitalar Universitário de Lisboa Norte;15877;4214;1511;0;21602
2019-01-01;Região de Saúde LVT;Hospital de Loures;10296;6071;1455;0;17822
2019-01-01;Região de Saúde Norte;Centro Hospitalar do Médio Ave;8004;3215;560;0;11779
2019-01-01;Região de Saúde Norte;Centro Hospitalar Universitário do Porto;10579;0;1815;0;12394
2019-01-01;Região de Saúde Norte;Hospital da Senhora da Oliveira;8245;3192;846;0;12283
2019-02-01;Região de Saúde Centro;Unidade Local de Saúde de Castelo Branco;8520;2106;283;0;10909
2019-02-01;Região de Saúde LVT;Centro Hospitalar Universitário Lisboa Central;22506;14061;3333;986;40886
2019-02-01;Região de Saúde LVT;Centro Hospitalar do Oeste;20330;9470;1622;0;31422
2019-02-01;Região de Saúde LVT;Hospital Distrital de Santarém;14419;7108;1374;0;22901
2019-02-01;Região de Saúde Norte;Centro Hospitalar do Médio Ave;15670;6681;1116;0;23467
2019-02-01;Região de Saúde Norte;Centro Hospitalar Póvoa de Varzim/Vila do Conde;12667;0;0;0;12667
2019-03-01;Região de Saúde Centro;Centro Hospitalar de Leiria;34090;9081;3010;0;46181
2019-03-01;Região de Saúde Centro;Unidade Local de Saúde de Castelo Branco;12814;3060;420;0;16294
2019-03-01;Região de Saúde LVT;Centro Hospitalar Universitário de Lisboa Norte;45248;11835;4516;0;61599
2019-03-01;Região de Saúde LVT;Hospital de Cascais;22574;14316;3463;0;40353
2019-03-01;Região de Saúde LVT;Hospital de Vila Franca de Xira;21584;12378;2362;0;36324
2019-03-01;Região de Saúde LVT;Hospital Distrital de Santarém;22425;9445;2205;0;34075
2019-03-01;Região de Saúde LVT;Hospital Professor Doutor Fernando Fonseca;45286;15412;5025;0;65723
2019-04-01;Região de Saúde Centro;Centro Hospitalar do Baixo Vouga;41155;13837;2268;0;57260
2019-04-01;Região de Saúde Centro;Centro Hospitalar Tondela-Viseu;35686;11375;5069;0;52130
2019-04-01;Região de Saúde LVT;Centro Hospitalar Universitário Lisboa Central;46087;26216;6976;2075;81354
2019-04-01;Região de Saúde LVT;Centro Hospitalar de Lisboa Ocidental;37480;11345;5113;0;53938
2019-04-01;Região de Saúde Norte;Centro Hospitalar Universitário de São João;53461;25989;4745;0;84195
2019-04-01;Região de Saúde Norte;Centro Hospitalar Tâmega e Sousa;46061;13305;4619;0;63985
2019-04-01;Região de Saúde Norte;Centro Hospitalar Trás-os-Montes e Alto Douro;48907;10271;1484;0;60662
2019-05-01;Região de Saúde Algarve;Centro Hospitalar Universitário do Algarve;104829;32058;8538;0;145425
2019-05-01;Região de Saúde Centro;Centro Hospitalar de Leiria;57073;14420;5225;0;76718
2019-05-01;Região de Saúde LVT;Centro Hospitalar de Lisboa Ocidental;47349;14157;6432;0;67938
2019-05-01;Região de Saúde LVT;Centro Hospitalar do Oeste;49755;20621;4178;0;74554
2019-05-01;Região de Saúde LVT;Centro Hospitalar Médio Tejo;48358;12437;1098;0;61893
2019-05-01;Região de Saúde LVT;Hospital de Cascais;37882;22914;5993;0;66789
2019-05-01;Região de Saúde LVT;Hospital Distrital de Santarém;35818;16515;3337;0;55670
2019-05-01;Região de Saúde LVT;Hospital Professor Doutor Fernando Fonseca;75054;24506;8741;0;108301
2019-05-01;Região de Saúde Norte;Centro Hospitalar Trás-os-Montes e Alto Douro;61510;12581;1864;0;75955
2019-05-01;Região de Saúde Norte;Hospital da Senhora da Oliveira;41056;13234;4054;0;58344
2019-06-01;Região de Saúde Alentejo;Unidade Local de Saúde do Baixo Alentejo;43429;8658;1779;0;53866
2019-06-01;Região de Saúde Centro;Centro Hospitalar de Leiria;68328;16964;6251;0;91543
2019-06-01;Região de Saúde Centro;Centro Hospitalar Tondela-Viseu;54486;16773;7602;0;78861
2019-06-01;Região de Saúde LVT;Centro Hospitalar de Setúbal;45522;20746;6633;0;72901
2019-06-01;Região de Saúde LVT;Centro Hospitalar do Oeste;59664;23934;4946;0;88544
2019-06-01;Região de Saúde LVT;Hospital de Cascais;45380;26859;7192;0;79431
2019-06-01;Região de Saúde LVT;Hospital de Vila Franca de Xira;42843;22832;5000;0;70675
2019-06-01;Região de Saúde LVT;Hospital Distrital de Santarém;42721;19498;3929;0;66148
2019-06-01;Região de Saúde Norte;Centro Hospitalar Universitário do Porto;63774;0;10998;0;74772
2019-06-01;Região de Saúde Norte;Centro Hospitalar Entre Douro e Vouga;85559;15981;4535;0;106075
2019-07-01;Região de Saúde Alentejo;Hospital Espírito Santo de Évora;31679;11816;0;0;43495
2019-07-01;Região de Saúde Algarve;Centro Hospitalar Universitário do Algarve;151491;43508;12384;0;207383
2019-07-01;Região de Saúde Centro;Centro Hospitalar de Leiria;80569;19351;7444;0;107364
2019-07-01;Região de Saúde Centro;Centro Hospitalar e Universitário de Coimbra;121307;37677;14424;0;173408
2019-07-01;Região de Saúde LVT;Centro Hospitalar de Lisboa Ocidental;65979;18871;9189;0;94039
2019-07-01;Região de Saúde LVT;Centro Hospitalar de Setúbal;53471;23533;7889;0;84893
2019-07-01;Região de Saúde LVT;Hospital Distrital de Santarém;50210;22024;4637;0;76871
2019-07-01;Região de Saúde Norte;Centro Hospitalar Entre Douro e Vouga;100642;18114;5355;0;124111
2019-07-01;Região de Saúde Norte;Centro Hospitalar Póvoa de Varzim/Vila do Conde;42236;0;0;0;42236
2019-07-01;Região de Saúde Norte;Unidade Local de Saúde de Matosinhos;45665;0;6136;0;51801
2019-08-01;Região de Saúde Alentejo;Hospital Espírito Santo de Évora;36303;13070;0;0;49373
2019-08-01;Região de Saúde Alentejo;Unidade Local de Saúde do Baixo Alentejo;57420;10724;2559;0;70703
2019-08-01;Região de Saúde Centro;Centro Hospitalar Universitário Cova da Beira;34303;10453;2456;0;47212
2019-08-01;Região de Saúde Centro;Centro Hospitalar de Leiria;93289;21544;8708;0;123541
2019-08-01;Região de Saúde Centro;Centro Hospitalar e Universitário de Coimbra;139122;41840;16711;0;197673
2019-08-01;Região de Saúde Centro;Unidade Local de Saúde de Castelo Branco;35006;7072;1114;0;43192
2019-08-01;Região de Saúde LVT;Centro Hospitalar Barreiro/Montijo;71752;23930;7369;0;103051
2019-08-01;Região de Saúde LVT;Centro Hospitalar Universitário Lisboa Central;94144;48110;14264;4315;160833
2019-08-01;Região de Saúde LVT;Centro Hospitalar do Oeste;81563;29787;7053;0;118403
2019-08-01;Região de Saúde LVT;Centro Hospitalar Universitário de Lisboa Norte;123458;28993;12505;0;164956
2019-08-01;Região de Saúde Norte;Centro Hospitalar Póvoa de Varzim/Vila do Conde;48303;0;0;0;48303
2019-09-01;Região de Saúde Norte;Unidade Local de Saúde de Matosinhos;58960;0;8000;0;66960
2019-09-01;Região de Saúde Norte;Unidade Local de Saúde do Alto Minho;105380;14211;5040;0;124631
2019-09-01;Região de Saúde Norte;Unidade Local de Saúde do Nordeste;83401;0;0;0;83401
2019-10-01;Região de Saúde Algarve;Centro Hospitalar Universitário do Algarve;225424;61735;18341;0;305500
2019-10-01;Região de Saúde Centro;Centro Hospitalar Universitário Cova da Beira;42865;12794;2951;0;58610
2019-10-01;Região de Saúde Centro;Unidade Local de Saúde de Castelo Branco;44055;8836;1355;0;54246
2019-10-01;Região de Saúde LVT;Centro Hospitalar Universitário de Lisboa Norte;155709;36836;15875;0;208420
2019-10-01;Região de Saúde LVT;Hospital Garcia de Orta;87416;36039;15014;0;138469
2019-10-01;Região de Saúde Norte;Centro Hospitalar Entre Douro e Vouga;145232;25336;7923;0;178491
2019-10-01;Região de Saúde Norte;Centro Hospitalar Tâmega e Sousa;119449;28623;12401;0;160473
2019-10-01;Região de Saúde Norte;Hospital de Braga;130792;39954;14235;0;184981
2019-10-01;Região de Saúde Norte;Unidade Local de Saúde de Matosinhos;65877;0;8923;0;74800
2019-10-01;Região de Saúde Norte;Unidade Local de Saúde do Alto Minho;117171;16013;5631;0;138815
2019-11-01;Região de Saúde Centro;Centro Hospitalar Universitário Cova da Beira;46955;14830;3264;0;65049
2019-11-01;Região de Saúde LVT;Centro Hospitalar de Setúbal;84514;36600;12801;0;133915
2019-11-01;Região de Saúde LVT;Centro Hospitalar Universitário de Lisboa Norte;170836;41361;17369;0;229566
2019-11-01;Região de Saúde LVT;Hospital de Loures;110995;54401;16966;0;182362
2019-11-01;Região de Saúde LVT;Hospital de Vila Franca de Xira;80059;40705;9546;0;130310
2019-11-01;Região de Saúde LVT;Hospital Professor Doutor Fernando Fonseca;165777;52212;20232;0;238221
2019-11-01;Região de Saúde Norte;Centro Hospitalar Trás-os-Montes e Alto Douro;138306;25400;4374;0;168080
2019-11-01;Região de Saúde Norte;Centro Hospitalar Vila Nova de Gaia/Espinho;119322;38257;11580;0;169159
2019-11-01;Região de Saúde Norte;Hospital de Braga;143356;44804;15534;0;203694
2019-12-01;Região de Saúde Algarve;Centro Hospitalar Universitário do Algarve;265797;75497;21605;0;362899
2019-12-01;Região de Saúde Centro;Centro Hospitalar Universitário Cova da Beira;51164;16224;3574;0;70962
2019-12-01;Região de Saúde Centro;Centro Hospitalar do Baixo Vouga;127857;40306;7647;0;175810
2019-12-01;Região de Saúde LVT;Centro Hospitalar Universitário Lisboa Central;142145;77635;21344;6533;247657
2019-12-01;Região de Saúde LVT;Centro Hospitalar de Setúbal;91968;41149;13819;0;146936
2019-12-01;Região de Saúde LVT;Hospital de Cascais;92747;53424;14851;0;161022
2019-12-01;Região de Saúde LVT;Hospital de Loures;121055;61039;18425;0;200519
2019-12-01;Região de Saúde Norte;Unidade Local de Saúde de Matosinhos;78893;0;10683;0;89576
2020-01-01;Região de Saúde Alentejo;Hospital Espírito Santo de Évora;4563;2014;0;0;6577
2020-01-01;Região de Saúde Centro;Hospital Distrital da Figueira da Foz;4555;1721;0;0;6276
2020-01-01;Região de Saúde LVT;Centro Hospitalar do Oeste;10758;4839;898;0;16495
2020-01-01;Região de Saúde LVT;Hospital de Loures;10112;5664;1607;0;17383
2020-01-01;Região de Saúde LVT;Hospital de Vila Franca de Xira;7646;4768;828;0;13242
2020-01-01;Região de Saúde Norte;Centro Hospitalar Entre Douro e Vouga;15732;3482;827;0;20041
2020-01-01;Região de Saúde Norte;Hospital de Braga;12850;4502;1419;0;18771
2020-01-01;Região de Saúde Norte;Unidade Local de Saúde de Matosinhos;7116;0;913;0;8029
2020-01-01;Região de Saúde Norte;Unidade Local de Saúde do Alto Minho;12433;2240;592;0;15265
2020-02-01;Região de Saúde Alentejo;Unidade Local de Saúde do Norte Alentejano;13771;1798;172;0;15741
2020-02-01;Região de Saúde Centro;Centro Hospitalar Tondela-Viseu;18359;6005;2515;0;26879
2020-02-01;Região de Saúde LVT;Centro Hospitalar de Setúbal;14496;7577;2250;0;24323
2020-02-01;Região de Saúde LVT;Centro Hospitalar do Oeste;20587;9205;1718;0;31510
2020-02-01;Região de Saúde LVT;Centro Hospitalar Universitário de Lisboa Norte;30871;8782;3040;0;42693
2020-02-01;Região de Saúde LVT;Hospital Professor Doutor Fernando Fonseca;30325;10816;3491;0;44632
2020-02-01;Região de Saúde Norte;Centro Hospitalar Vila Nova de Gaia/Espinho;21296;7678;2035;0;31009
2020-03-01;Região de Saúde LVT;Centro Hospitalar de Setúbal;19542;9173;3041;0;31756
2020-03-01;Região de Saúde LVT;Centro Hospitalar Médio Tejo;25543;6233;778;0;32554
2020-03-01;Região de Saúde LVT;Hospital Garcia de Orta;23929;7351;4185;0;35465
2020-03-01;Região de Saúde Norte;Centro Hospitalar Vila Nova de Gaia/Espinho;28416;9143;2757;0;40316
2020-03-01;Região de Saúde Norte;Unidade Local de Saúde de Matosinhos;18626;0;2459;0;21085
2020-04-01;Região de Saúde Alentejo;Unidade Local de Saúde do Litoral Alentejano;24819;0;0;0;24819
2020-04-01;Região de Saúde Centro;Centro Hospitalar Universitário Cova da Beira;13152;3512;989;0;17653
2020-04-01;Região de Saúde Centro;Centro Hospitalar Tondela-Viseu;29383;7988;4370;0;41741
2020-04-01;Região de Saúde Centro;Unidade Local de Saúde da Guarda;20224;3913;1383;0;25520
2020-04-01;Região de Saúde LVT;Centro Hospitalar de Setúbal;24028;9875;3667;0;37570
2020-04-01;Região de Saúde Norte;Centro Hospitalar Universitário de São João;47206;18940;3662;0;69808
2020-04-01;Região de Saúde Norte;Centro Hospitalar Vila Nova de Gaia/Espinho;35360;9881;3377;0;48618
2020-04-01;Região de Saúde Norte;Hospital da Senhora da Oliveira;26089;7066;2752;0;35907
2020-05-01;Região de Saúde Centro;Centro Hospitalar do Baixo Vouga;40441;9318;2387;0;52146
2020-05-01;Região de Saúde LVT;Centro Hospitalar de Lisboa Ocidental;37312;8881;4795;0;50988
2020-05-01;Região de Saúde LVT;Centro Hospitalar do Oeste;38201;12509;3280;0;53990
2020-05-01;Região de Saúde LVT;Hospital de Vila Franca de Xira;29474;13049;3558;0;46081
2020-05-01;Região de Saúde Norte;Centro Hospitalar Universitário do Porto;44919;0;8290;0;53209
2020-05-01;Região de Saúde Norte;Centro Hospitalar Entre Douro e Vouga;54608;8287;2915;0;65810
2020-06-01;Região de Saúde Centro;Unidade Local de Saúde de Castelo Branco;20293;3264;653;0;24210
2020-06-01;Região de Saúde LVT;Centro Hospitalar Barreiro/Montijo;42272;11800;4114;0;58186
2020-06-01;Região de Saúde LVT;Hospital de Cascais;35143;15002;5388;0;55533
2020-06-01;Região de Saúde LVT;Hospital Distrital de Santarém;32847;10260;3274;0;46381
2020-06-01;Região de Saúde Norte;Centro Hospitalar Póvoa de Varzim/Vila do Conde;26870;0;0;0;26870
2020-06-01;Região de Saúde Norte;Centro Hospitalar Tâmega e Sousa;61422;11725;6142;0;79289
2020-06-01;Região de Saúde Norte;Hospital da Senhora da Oliveira;37206;8354;4044;0;49604
2020-06-01;Região de Saúde Norte;Unidade Local de Saúde do Alto Minho;48303;5804;2297;0;56404
2020-07-01;Região de Saúde Centro;Centro Hospitalar de Leiria;62355;10889;5970;0;79214
2020-07-01;Região de Saúde Centro;Centro Hospitalar e Universitário de Coimbra;88620;23909;12025;0;124554
2020-07-01;Região de Saúde Centro;Unidade Local de Saúde da Guarda;32590;5251;2327;0;40168
2020-07-01;Região de Saúde LVT;Centro Hospitalar de Setúbal;40956;13336;6080;0;60372
2020-07-01;Região de Saúde LVT;Hospital de Cascais;41038;16783;6354;0;64175
2020-07-01;Região de Saúde Norte;Centro Hospitalar do Médio Ave;42894;10510;3326;0;56730
2020-08-01;Região de Saúde Centro;Centro Hospitalar Universitário Cova da Beira;25937;5184;1944;0;33065
2020-08-01;Região de Saúde Centro;Centro Hospitalar de Leiria;72004;12242;6856;0;91102
2020-08-01;Região de Saúde LVT;Centro Hospitalar Universitário Lisboa Central;68750;31548;11562;3652;115512
2020-08-01;Região de Saúde Norte;Centro Hospitalar Entre Douro e Vouga;86301;11091;4573;0;101965
2020-08-01;Região de Saúde Norte;Unidade Local de Saúde do Nordeste;54141;0;0;0;54141
2020-09-01;Região de Saúde Centro;Centro Hospitalar do Baixo Vouga;72940;14658;4470;0;92068
2020-09-01;Região de Saúde LVT;Centro Hospitalar de Lisboa Ocidental;63815;13495;9015;0;86325
2020-09-01;Região de Saúde Norte;Centro Hospitalar do Médio Ave;55543;12973;4310;0;72826
2020-09-01;Região de Saúde Norte;Centro Hospitalar Universitário do Porto;80175;0;15531;0;95706
2020-09-01;Região de Saúde Norte;Hospital de Braga;93083;20892;9295;0;123270
2020-09-01;Região de Saúde Norte;Hospital Santa Maria Maior;29633;5041;0;0;34674
2020-10-01;Região de Saúde Alentejo;Unidade Local de Saúde do Baixo Alentejo;52142;7520;2730;0;62392
2020-10-01;Região de Saúde LVT;Centro Hospitalar Universitário de Lisboa Norte;112280;22136;11872;0;146288
2020-10-01;Região de Saúde Norte;Centro Hospitalar do Médio Ave;61718;14472;4781;0;80971
2020-10-01;Região de Saúde Norte;Centro Hospitalar Tâmega e Sousa;110241;18759;10790;0;139790
2020-10-01;Região de Saúde Norte;Unidade Local de Saúde do Alto Minho;81719;8646;4186;0;94551
2020-11-01;Região de Saúde Alentejo;Unidade Local de Saúde do Norte Alentejano;52746;4476;1259;0;58481
2020-11-01;Região de Saúde Centro;Centro Hospitalar do Baixo Vouga;88694;18479;5399;0;112572
2020-11-01;Região de Saúde LVT;Centro Hospitalar de Lisboa Ocidental;76589;16840;10916;0;104345
2020-11-01;Região de Saúde LVT;Hospital de Cascais;64370;25798;10375;0;100543
2020-11-01;Região de Saúde Norte;Centro Hospitalar Tâmega e Sousa;119855;20143;11662;0;151660
2020-11-01;Região de Saúde Norte;Centro Hospitalar Trás-os-Montes e Alto Douro;101441;13884;5191;0;120516
2020-11-01;Região de Saúde Norte;Centro Hospitalar Vila Nova de Gaia/Espinho;98179;20429;9411;0;128019
2020-11-01;Região de Saúde Norte;Hospital de Braga;112779;25311;11126;0;149216
2020-11-01;Região de Saúde Norte;Unidade Local de Saúde do Alto Minho;88449;9328;4578;0;102355
2020-12-01;Região de Saúde Alentejo;Unidade Local de Saúde do Litoral Alentejano;67701;0;0;0;67701
2020-12-01;Região de Saúde Alentejo;Unidade Local de Saúde do Norte Alentejano;56745;4701;1337;0;62783
2020-12-01;Região de Saúde Centro;Centro Hospitalar Universitário Cova da Beira;38080;7117;2889;0;48086
2020-12-01;Região de Saúde Centro;Centro Hospitalar de Leiria;104638;17788;10198;0;132624
2020-12-01;Região de Saúde Centro;Hospital Distrital da Figueira da Foz;42436;9829;0;0;52265
2020-12-01;Região de Saúde Centro;Unidade Local de Saúde da Guarda;58282;9045;3848;0;71175
2021-01-01;Região de Saúde Centro;Centro Hospitalar do Baixo Vouga;7454;1263;443;0;9160
2021-01-01;Região de Saúde Centro;Centro Hospitalar e Universitário de Coimbra;10694;2527;1511;0;14732
2021-01-01;Região de Saúde LVT;Hospital de Loures;5673;1567;788;0;8028
2021-01-01;Região de Saúde LVT;Hospital Professor Doutor Fernando Fonseca;10263;1834;1090;0;13187
2021-01-01;Região de Saúde Norte;Centro Hospitalar Universitário de São João;10177;3160;759;0;14096
2021-01-01;Região de Saúde Norte;Centro Hospitalar Póvoa de Varzim/Vila do Conde;4114;0;0;0;4114
2021-01-01;Região de Saúde Norte;Hospital de Braga;9265;1618;837;0;11720
2021-01-01;Região de Saúde Norte;Hospital Santa Maria Maior;3327;263;0;0;3590
2021-01-01;Região de Saúde Norte;Unidade Local de Saúde do Nordeste;5747;0;0;0;5747
2021-02-01;Região de Saúde Alentejo;Unidade Local de Saúde do Norte Alentejano;7036;400;190;0;7626
2021-02-01;Região de Saúde Centro;Centro Hospitalar do Baixo Vouga;13006;1963;862;0;15831
2021-02-01;Região de Saúde Centro;Hospital Distrital da Figueira da Foz;5773;868;0;0;6641
2021-02-01;Região de Saúde LVT;Centro Hospitalar Barreiro/Montijo;10702;1927;990;0;13619
2021-02-01;Região de Saúde LVT;Hospital de Vila Franca de Xira;9065;2114;1001;0;12180
2021-02-01;Região de Saúde Norte;Centro Hospitalar Universitário de São João;18834;5066;1544;0;25444
2021-02-01;Região de Saúde Norte;Hospital de Braga;16940;2624;1647;0;21211
2021-03-01;Região de Saúde Norte;Centro Hospitalar do Médio Ave;15705;2412;1250;0;19367
2021-03-01;Região de Saúde Norte;Centro Hospitalar Vila Nova de Gaia/Espinho;23110;3644;2179;0;28933
2021-03-01;Região de Saúde Norte;Unidade Local de Saúde do Nordeste;15606;0;0;0;15606
2021-04-01;Região de Saúde Norte;Centro Hospitalar Tâmega e Sousa;37011;5341;3625;0;45977
2021-04-01;Região de Saúde Norte;Hospital da Senhora da Oliveira;23509;3277;2501;0;29287
2021-04-01;Região de Saúde Norte;Unidade Local de Saúde do Alto Minho;27933;1966;1478;0;31377
2021-05-01;Região de Saúde Centro;Centro Hospitalar Tondela-Viseu;35755;6440;5152;0;47347
2021-05-01;Região de Saúde LVT;Centro Hospitalar Universitário Lisboa Central;39700;18891;6630;2165;67386
2021-05-01;Região de Saúde LVT;Centro Hospitalar do Oeste;32506;7602;3007;0;43115
2021-05-01;Região de Saúde LVT;Centro Hospitalar Universitário de Lisboa Norte;44293;8939;5844;0;59076
2021-05-01;Região de Saúde LVT;Centro Hospitalar Médio Tejo;33531;5274;1245;0;40050
2021-05-01;Região de Saúde LVT;Hospital Professor Doutor Fernando Fonseca;55303;11655;6155;0;73113
2021-05-01;Região de Saúde Norte;Centro Hospitalar Trás-os-Montes e Alto Douro;44304;4724;2632;0;51660
2021-06-01;Região de Saúde Alentejo;Hospital Espírito Santo de Évora;20973;5129;0;0;26102
2021-06-01;Região de Saúde Alentejo;Unidade Local de Saúde do Baixo Alentejo;29335;4719;1677;0;35731
2021-06-01;Região de Saúde LVT;Centro Hospitalar Barreiro/Montijo;38490;10155;3691;0;52336
2021-06-01;Região de Saúde LVT;Centro Hospitalar de Lisboa Ocidental;36915;9868;5624;0;52407
2021-06-01;Região de Saúde LVT;Centro Hospitalar do Oeste;41523;10991;3703;0;56217
2021-06-01;Região de Saúde Norte;Centro Hospitalar Universitário de São João;70854;25477;5529;0;101860
2021-06-01;Região de Saúde Norte;Centro Hospitalar Trás-os-Montes e Alto Douro;55195;6690;3242;0;65127
2021-06-01;Região de Saúde Norte;Hospital da Senhora da Oliveira;39223;7537;4006;0;50766
2021-06-01;Região de Saúde Norte;Hospital Santa Maria Maior;20077;2615;0;0;22692
2021-07-01;Região de Saúde Centro;Unidade Local de Saúde da Guarda;33677;5761;2114;0;41552
2021-07-01;Região de Saúde LVT;Centro Hospitalar de Lisboa Ocidental;44464;12220;6840;0;63524
2021-07-01;Região de Saúde LVT;Centro Hospitalar Médio Tejo;50906;9470;1906;0;62282
2021-07-01;Região de Saúde Norte;Centro Hospitalar Entre Douro e Vouga;77298;10586;4167;0;92051
2021-07-01;Região de Saúde Norte;Centro Hospitalar Tâmega e Sousa;75516;13996;7145;0;96657
2021-08-01;Região de Saúde Alentejo;Unidade Local de Saúde do Baixo Alentejo;41977;7263;2272;0;51512
2021-08-01;Região de Saúde Alentejo;Unidade Local de Saúde do Litoral Alentejano;46833;0;0;0;46833
2021-08-01;Região de Saúde LVT;Centro Hospitalar de Lisboa Ocidental;51821;13789;7924;0;73534
2021-08-01;Região de Saúde LVT;Hospital de Loures;55674;20405;8434;0;84513
2021-09-01;Região de Saúde Alentejo;Unidade Local de Saúde do Norte Alentejano;45015;3581;1034;0;49630
2021-09-01;Região de Saúde LVT;Centro Hospitalar de Setúbal;55146;18917;7426;0;81489
2021-09-01;Região de Saúde LVT;Centro Hospitalar Médio Tejo;69190;13185;2611;0;84986
2021-09-01;Região de Saúde Norte;Centro Hospitalar Trás-os-Montes e Alto Douro;91661;12354;5277;0;109292
2021-09-01;Região de Saúde Norte;Unidade Local de Saúde do Nordeste;61695;0;0;0;61695
2021-10-01;Região de Saúde Centro;Unidade Local de Saúde de Castelo Branco;34703;7152;1133;0;42988
2021-10-01;Região de Saúde LVT;Centro Hospitalar de Lisboa Ocidental;67189;19788;10220;0;97197
2021-10-01;Região de Saúde LVT;Centro Hospitalar do Oeste;80372;24421;6514;0;111307
2021-10-01;Região de Saúde LVT;Hospital Distrital de Santarém;59045;15832;5686;0;80563
2021-10-01;Região de Saúde Norte;Centro Hospitalar Trás-os-Montes e Alto Douro;103551;15215;5850;0;124616
2021-10-01;Região de Saúde Norte;Hospital da Senhora da Oliveira;71773;17098;7109;0;95980
2021-10-01;Região de Saúde Norte;Unidade Local de Saúde de Matosinhos;62050;0;7711;0;69761
2021-11-01;Região de Saúde Centro;Centro Hospitalar de Leiria;106633;21868;9692;0;138193
2021-11-01;Região de Saúde LVT;Centro Hospitalar Barreiro/Montijo;77926;24456;7631;0;110013
2021-11-01;Região de Saúde LVT;Centro Hospitalar de Setúbal;67629;27038;9041;0;103708
2021-11-01;Região de Saúde LVT;Hospital de Vila Franca de Xira;67381;30045;7102;0;104528
2021-11-01;Região de Saúde Norte;Centro Hospitalar Universitário de São João;143467;59433;11080;0;213980
2021-11-01;Região de Saúde Norte;Centro Hospitalar Trás-os-Montes e Alto Douro;115117;17887;6463;0;139467
2021-11-01;Região de Saúde Norte;Centro Hospitalar Vila Nova de Gaia/Espinho;109416;29764;9584;0;148764
2021-11-01;Região de Saúde Norte;Hospital da Senhora da Oliveira;79719;20017;7929;0;107665
2021-11-01;Região de Saúde Norte;Hospital Santa Maria Maior;41305;7780;0;0;49085
2021-11-01;Região de Saúde Norte;Unidade Local de Saúde do Alto Minho;101015;11292;4682;0;116989
2021-12-01;Região de Saúde Alentejo;Unidade Local de Saúde do Baixo Alentejo;67282;13378;3481;0;84141
2021-12-01;Região de Saúde LVT;Centro Hospitalar Universitário Lisboa Central;114577;65583;17849;5740;203749
2021-12-01;Região de Saúde LVT;Hospital de Cascais;75120;37903;10932;0;123955
2021-12-01;Região de Saúde LVT;Hospital Garcia de Orta;83340;28281;15262;0;126883
2021-12-01;Região de Saúde Norte;Centro Hospitalar Póvoa de Varzim/Vila do Conde;60488;0;0;0;60488
2021-12-01;Região de Saúde Norte;Hospital da Senhora da Oliveira;87626;22700;8662;0;118988
2021-12-01;Região de Saúde Norte;Unidade Local de Saúde do Alto Minho;111863;12230;4766;0;128859
2022-01-01;Região de Saúde Alentejo;Unidade Local de Saúde do Baixo Alentejo;6131;1885;318;0;8334
2022-01-01;Região de Saúde Centro;Hospital Distrital da Figueira da Foz;3890;1069;0;0;4959
2022-01-01;Região de Saúde LVT;Centro Hospitalar Barreiro/Montijo;7781;2112;736;0;10629
2022-01-01;Região de Saúde LVT;Centro Hospitalar do Oeste;8285;2359;687;0;11331
2022-01-01;Região de Saúde LVT;Centro Hospitalar Universitário de Lisboa Norte;11354;2558;1391;0;15303
2022-01-01;Região de Saúde Norte;Centro Hospitalar Universitário de São João;12697;5403;1092;0;19192
2022-01-01;Região de Saúde Norte;Centro Hospitalar Entre Douro e Vouga;13763;2113;629;0;16505
2022-02-01;Região de Saúde LVT;Centro Hospitalar de Setúbal;12876;5883;1589;0;20348
2022-02-01;Região de Saúde LVT;Hospital de Vila Franca de Xira;11988;5953;1256;0;19197
2022-02-01;Região de Saúde LVT;Hospital Distrital de Santarém;12391;3628;1183;0;17202
2022-02-01;Região de Saúde Norte;Hospital de Braga;22526;5901;1981;0;30408
2022-03-01;Região de Saúde Alentejo;Unidade Local de Saúde do Norte Alentejano;16700;2258;566;0;19524
2022-03-01;Região de Saúde LVT;Hospital de Loures;23496;12775;3274;0;39545
2022-03-01;Região de Saúde LVT;Hospital de Vila Franca de Xira;19318;11173;2016;0;32507
2022-03-01;Região de Saúde Norte;Centro Hospitalar Universitário do Porto;29505;0;4885;0;34390
2022-03-01;Região de Saúde Norte;Centro Hospitalar Entre Douro e Vouga;41663;8037;2132;0;51832
2022-03-01;Região de Saúde Norte;Centro Hospitalar Vila Nova de Gaia/Espinho;31164;9921;2391;0;43476
2022-03-01;Região de Saúde Norte;Unidade Local de Saúde de Matosinhos;20042;0;2241;0;22283
2022-03-01;Região de Saúde Norte;Unidade Local de Saúde do Nordeste;23974;0;0;0;23974
2022-04-01;Região de Saúde Alentejo;Unidade Local de Saúde do Baixo Alentejo;25815;6789;1201;0;33805
2022-04-01;Região de Saúde Centro;Unidade Local de Saúde da Guarda;23164;4742;1232;0;29138
2022-04-01;Região de Saúde Norte;Centro Hospitalar do Médio Ave;28798;10538;2050;0;41386
2022-04-01;Região de Saúde Norte;Centro Hospitalar Universitário do Porto;39879;0;6664;0;46543
2022-04-01;Região de Saúde Norte;Centro Hospitalar Tâmega e Sousa;49572;13340;4556;0;67468
2022-04-01;Região de Saúde Norte;Hospital de Braga;47722;14484;4284;0;66490
2022-04-01;Região de Saúde Norte;Unidade Local de Saúde de Matosinhos;26883;0;2989;0;29872
2022-04-01;Região de Saúde Norte;Unidade Local de Saúde do Nordeste;32465;0;0;0;32465
2022-05-01;Região de Saúde Centro;Centro Hospitalar Universitário Cova da Beira;19530;5834;1397;56;26817
2022-05-01;Região de Saúde Centro;Centro Hospitalar do Baixo Vouga;53227;17874;2539;0;73640
2022-05-01;Região de Saúde Centro;Unidade Local de Saúde de Castelo Branco;20252;5870;652;0;26774
2022-05-01;Região de Saúde LVT;Centro Hospitalar Barreiro/Montijo;42537;16250;3946;0;62733
2022-05-01;Região de Saúde LVT;Centro Hospitalar do Oeste;46623;19617;3396;0;69636
2022-05-01;Região de Saúde LVT;Centro Hospitalar Médio Tejo;47140;13678;1700;0;62518
2022-05-01;Região de Saúde Norte;Centro Hospitalar do Médio Ave;37403;13657;2636;0;53696
2022-05-01;Região de Saúde Norte;Centro Hospitalar Vila Nova de Gaia/Espinho;54812;18530;3678;0;77020
2022-06-01;Região de Saúde Centro;Centro Hospitalar Tondela-Viseu;53852;17107;7137;0;78096
2022-06-01;Região de Saúde LVT;Centro Hospitalar Médio Tejo;57020;16008;2031;0;75059
2022-06-01;Região de Saúde LVT;Hospital Garcia de Orta;43919;23098;8129;0;75146
2022-06-01;Região de Saúde Norte;Centro Hospitalar Entre Douro e Vouga;88587;17357;4269;0;110213
2022-06-01;Região de Saúde Norte;Hospital Santa Maria Maior;25715;6929;0;0;32644
2022-07-01;Região de Saúde Alentejo;Unidade Local de Saúde do Baixo Alentejo;46394;10872;2138;0;59404
2022-07-01;Região de Saúde Algarve;Centro Hospitalar Universitário do Algarve;158654;41357;11609;0;211620
2022-07-01;Região de Saúde LVT;Centro Hospitalar do Oeste;65524;26413;4717;0;96654
2022-07-01;Região de Saúde LVT;Centro Hospitalar Médio Tejo;66682;18076;2327;0;87085
2022-07-01;Região de Saúde LVT;Hospital Garcia de Orta;51394;26585;9548;0;87527
2022-07-01;Região de Saúde Norte;Centro Hospitalar Universitário do Porto;73430;0;11911;0;85341
2022-07-01;Região de Saúde Norte;Centro Hospitalar Tâmega e Sousa;89116;22748;8237;0;120101
2022-07-01;Região de Saúde Norte;Centro Hospitalar Vila Nova de Gaia/Espinho;77554;25308;4916;0;107778
2022-08-01;Região de Saúde Algarve;Centro Hospitalar Universitário do Algarve;187526;46880;13556;0;247962
2022-08-01;Região de Saúde Centro;Centro Hospitalar de Leiria;90320;21119;7881;0;119320
2022-08-01;Região de Saúde Centro;Centro Hospitalar Tondela-Viseu;73381;21927;9991;0;105299
2022-08-01;Região de Saúde LVT;Centro Hospitalar Universitário Lisboa Central;90535;51858;13352;4426;160171
2022-08-01;Região de Saúde LVT;Centro Hospitalar de Lisboa Ocidental;64279;22580;9562;0;96421
2022-09-01;Região de Saúde Algarve;Centro Hospitalar Universitário do Algarve;211475;52079;15337;0;278891
2022-09-01;Região de Saúde Centro;Centro Hospitalar Tondela-Viseu;82352;24334;11351;0;118037
2022-09-01;Região de Saúde LVT;Centro Hospitalar Barreiro/Montijo;77528;26587;7451;0;111566
2022-09-01;Região de Saúde LVT;Hospital Distrital de Santarém;62513;21306;5848;0;89667
2022-09-01;Região de Saúde Norte;Centro Hospitalar Entre Douro e Vouga;134235;24798;6802;0;165835
2022-09-01;Região de Saúde Norte;Unidade Local de Saúde de Matosinhos;63265;0;7176;0;70441
2022-10-01;Região de Saúde Alentejo;Unidade Local de Saúde do Norte Alentejano;59276;6778;1967;0;68021
2022-10-01;Região de Saúde Centro;Hospital Distrital da Figueira da Foz;45132;15516;0;0;60648
2022-10-01;Região de Saúde LVT;Centro Hospitalar Barreiro/Montijo;87061;30996;8304;0;126361
2022-10-01;Região de Saúde LVT;Hospital de Cascais;74909;42508;10881;0;128298
2022-10-01;Região de Saúde LVT;Hospital Distrital de Santarém;69807;25284;6556;0;101647
2022-10-01;Região de Saúde Norte;Centro Hospitalar Póvoa de Varzim/Vila do Conde;61076;0;0;0;61076
2022-11-01;Região de Saúde Centro;Centro Hospitalar Tondela-Viseu;100526;32390;13984;0;146900
2022-11-01;Região de Saúde Centro;Hospital Distrital da Figueira da Foz;49317;18198;0;0;67515
2022-11-01;Região de Saúde LVT;Centro Hospitalar do Oeste;104713;45083;7646;0;157442
2022-11-01;Região de Saúde LVT;Hospital de Vila Franca de Xira;74099;44101;7916;0;126116
2022-11-01;Região de Saúde Norte;Centro Hospitalar Trás-os-Montes e Alto Douro;135512;27999;7277;0;170788
2022-11-01;Região de Saúde Norte;Hospital da Senhora da Oliveira;92512;31979;9481;0;133972
2022-11-01;Região de Saúde Norte;Hospital de Braga;132576;41482;11843;0;185901
2022-12-01;Região de Saúde Centro;Centro Hospitalar e Universitário de Coimbra;182251;71261;22725;0;276237
2022-12-01;Região de Saúde Centro;Hospital Distrital da Figueira da Foz;53798;19828;0;0;73626
2022-12-01;Região de Saúde LVT;Centro Hospitalar do Oeste;114002;50088;8249;0;172339
2022-12-01;Região de Saúde Norte;Centro Hospitalar Vila Nova de Gaia/Espinho;134256;46713;8154;0;189123
2022-12-01;Região de Saúde Norte;Hospital Santa Maria Maior;52724;14296;0;0;67020
2022-12-01;Região de Saúde Norte;Unidade Local de Saúde de Matosinhos;83767;0;9520;0;93287
2023-01-01;Região de Saúde Alentejo;Hospital Espírito Santo de Évora;4410;1534;0;0;5944
2023-01-01;Região de Saúde Alentejo;Unidade Local de Saúde do Litoral Alentejano;7809;0;0;0;7809
2023-01-01;Região de Saúde Alentejo;Unidade Local de Saúde do Norte Alentejano;6276;670;181;0;7127
2023-01-01;Região de Saúde Algarve;Centro Hospitalar Universitário do Algarve;22013;5399;1629;0;29041
2023-01-01;Região de Saúde Centro;Centro Hospitalar de Leiria;10428;2664;1024;0;14116
2023-01-01;Região de Saúde Centro;Hospital Distrital da Figueira da Foz;4182;1557;0;0;5739
2023-01-01;Região de Saúde Centro;Unidade Local de Saúde da Guarda;6616;1438;365;0;8419
2023-01-01;Região de Saúde Centro;Unidade Local de Saúde de Castelo Branco;4523;1256;133;0;5912
2023-01-01;Região de Saúde LVT;Centro Hospitalar de Lisboa Ocidental;7811;2854;1126;0;11791
2023-01-01;Região de Saúde Norte;Centro Hospitalar Póvoa de Varzim/Vila do Conde;6052;0;0;0;6052
2023-01-01;Região de Saúde Norte;Centro Hospitalar Tâmega e Sousa;12414;3040;1191;0;16645
2023-01-01;Região de Saúde Norte;Hospital da Senhora da Oliveira;8667;2924;837;0;12428
2023-02-01;Região de Saúde Alentejo;Unidade Local de Saúde do Norte Alentejano;12463;1403;363;0;14229
2023-02-01;Região de Saúde Algarve;Centro Hospitalar Universitário do Algarve;42967;11117;3033;0;57117
2023-02-01;Região de Saúde Centro;Centro Hospitalar e Universitário de Coimbra;28789;10906;3471;0;43166
2023-02-01;Região de Saúde LVT;Centro Hospitalar Universitário de Lisboa Norte;22259;6940;2830;0;32029
2023-02-01;Região de Saúde LVT;Hospital de Vila Franca de Xira;12832;7812;1230;0;21874
2023-03-01;Região de Saúde Centro;Centro Hospitalar e Universitário de Coimbra;44202;17000;5305;0;66507
2023-03-01;Região de Saúde Centro;Centro Hospitalar Tondela-Viseu;27014;8983;3650;0;39647
2023-03-01;Região de Saúde LVT;Centro Hospitalar Barreiro/Montijo;28326;10638;2311;0;41275
2023-03-01;Região de Saúde LVT;Centro Hospitalar Médio Tejo;28674;9456;931;0;39061
2023-03-01;Região de Saúde LVT;Hospital de Vila Franca de Xira;19944;12359;1902;0;34205
2023-03-01;Região de Saúde Norte;Centro Hospitalar Universitário de São João;42659;20194;3033;0;65886
2023-03-01;Região de Saúde Norte;Centro Hospitalar do Médio Ave;21467;8686;1647;0;31800
2023-03-01;Região de Saúde Norte;Centro Hospitalar Vila Nova de Gaia/Espinho;33311;11222;1966;0;46499
2023-03-01;Região de Saúde Norte;Hospital Santa Maria Maior;13139;3762;0;0;16901
2023-03-01;Região de Saúde Norte;Unidade Local de Saúde do Nordeste;24922;0;0;0;24922
2023-04-01;Região de Saúde Alentejo;Unidade Local de Saúde do Litoral Alentejano;31721;0;0;0;31721
2023-04-01;Região de Saúde Centro;Unidade Local de Saúde da Guarda;25651;5398;1339;0;32388
2023-04-01;Região de Saúde LVT;Centro Hospitalar Universitário Lisboa Central;44188;27645;7055;1931;80819
2023-04-01;Região de Saúde LVT;Centro Hospitalar Médio Tejo;38216;12153;1315;0;51684
2023-04-01;Região de Saúde LVT;Hospital de Vila Franca de Xira;26466;16053;2582;0;45101
2023-04-01;Região de Saúde LVT;Hospital Distrital de Santarém;27099;10506;2508;0;40113
2023-04-01;Região de Saúde LVT;Hospital Professor Doutor Fernando Fonseca;57628;19996;6321;0;83945
2023-04-01;Região de Saúde Norte;Centro Hospitalar Vila Nova de Gaia/Espinho;44621;14808;2682;0;62111
2023-04-01;Região de Saúde Norte;Hospital da Senhora da Oliveira;34022;11898;3398;0;49318
2023-04-01;Região de Saúde Norte;Hospital de Braga;48667;15827;4376;0;68870
2023-05-01;Região de Saúde Alentejo;Unidade Local de Saúde do Litoral Alentejano;40117;0;0;0;40117
2023-05-01;Região de Saúde Centro;Centro Hospitalar Tondela-Viseu;45902;14921;6071;0;66894
2023-05-01;Região de Saúde Centro;Unidade Local de Saúde de Castelo Branco;21843;6633;716;0;29192
2023-05-01;Região de Saúde LVT;Centro Hospitalar Barreiro/Montijo;47472;17145;3918;0;68535
2023-05-01;Região de Saúde LVT;Centro Hospitalar Universitário Lisboa Central;54860;34366;8840;2459;100525
2023-05-01;Região de Saúde LVT;Centro Hospitalar Universitário de Lisboa Norte;58186;19687;7328;0;85201
2023-05-01;Região de Saúde LVT;Centro Hospitalar Médio Tejo;48536;15362;1731;0;65629
2023-05-01;Região de Saúde LVT;Hospital Distrital de Santarém;34320;13374;3188;0;50882
2023-05-01;Região de Saúde Norte;Centro Hospitalar Tâmega e Sousa;63986;16082;6131;0;86199
2023-05-01;Região de Saúde Norte;Centro Hospitalar Universitário de Santo António;52703;0;8260;0;60963
2023-06-01;Região de Saúde Alentejo;Unidade Local de Saúde do Baixo Alentejo;45154;8898;1997;0;56049
2023-06-01;Região de Saúde Alentejo;Unidade Local de Saúde do Norte Alentejano;38668;4510;1222;0;44400
2023-06-01;Região de Saúde Centro;Centro Hospitalar Universitário Cova da Beira;24441;7511;1946;216;34114
2023-06-01;Região de Saúde Centro;Centro Hospitalar de Leiria;65307;16053;6780;0;88140
2023-06-01;Região de Saúde Centro;Centro Hospitalar Tondela-Viseu;55520;17512;7308;0;80340
2023-06-01;Região de Saúde LVT;Centro Hospitalar do Oeste;58037;24089;3010;0;85136
2023-06-01;Região de Saúde LVT;Hospital Professor Doutor Fernando Fonseca;87369;30139;9960;0;127468
2023-06-01;Região de Saúde Norte;Centro Hospitalar Universitário de São João;87840;40285;6455;0;134580
2023-06-01;Região de Saúde Norte;Centro Hospitalar Tâmega e Sousa;77141;19218;7445;0;103804
2023-06-01;Região de Saúde Norte;Centro Hospitalar Trás-os-Montes e Alto Douro;75030;15743;4135;0;94908
2023-06-01;Região de Saúde Norte;Centro Hospitalar Universitário de Santo António;63603;0;9841;0;73444
2023-06-01;Região de Saúde Norte;Hospital de Braga;74838;24030;6802;0;105670
2023-06-01;Região de Saúde Norte;Unidade Local de Saúde do Alto Minho;69447;10297;3240;0;82984
2023-06-01;Região de Saúde Norte;Unidade Local de Saúde do Nordeste;49545;0;0;0;49545
2023-07-01;Região de Saúde Alentejo;Hospital Espírito Santo de Évora;30341;10413;0;0;40754
2023-07-01;Região de Saúde Centro;Centro Hospitalar e Universitário de Coimbra;106515;38090;12977;0;157582
2023-07-01;Região de Saúde Centro;Unidade Local de Saúde de Castelo Branco;30967;9142;1030;0;41139
2023-07-01;Região de Saúde LVT;Centro Hospitalar Universitário Lisboa Central;78894;46920;13147;3613;142574
2023-07-01;Região de Saúde LVT;Centro Hospitalar de Setúbal;44630;20295;5686;0;70611
2023-07-01;Região de Saúde LVT;Centro Hospitalar do Oeste;68558;27470;3023;0;99051
2023-07-01;Região de Saúde LVT;Hospital Professor Doutor Fernando Fonseca;102032;34149;11824;0;148005
2023-07-01;Região de Saúde Norte;Centro Hospitalar Universitário de São João;103057;46215;7639;0;156911
2023-07-01;Região de Saúde Norte;Centro Hospitalar Entre Douro e Vouga;108852;20585;5086;0;134523
2023-07-01;Região de Saúde Norte;Centro Hospitalar Póvoa de Varzim/Vila do Conde;41388;0;0;0;41388
2023-07-01;Região de Saúde Norte;Centro Hospitalar Tâmega e Sousa;91017;21923;8937;0;121877
2023-07-01;Região de Saúde Norte;Centro Hospitalar Trás-os-Montes e Alto Douro;88834;17945;4861;0;111640
2023-07-01;Região de Saúde Norte;Centro Hospitalar Universitário de Santo António;74767;0;11649;0;86416
2023-08-01;Região de Saúde Alentejo;Unidade Local de Saúde do Norte Alentejano;52215;5641;1654;0;59510
2023-08-01;Região de Saúde LVT;Centro Hospitalar Universitário de Lisboa Norte;94706;30109;10319;0;135134
2023-08-01;Região de Saúde LVT;Hospital de Vila Franca de Xira;54442;29673;5807;0;89922
2023-08-01;Região de Saúde LVT;Hospital Professor Doutor Fernando Fonseca;117488;37696;13695;0;168879
2023-08-01;Região de Saúde Norte;Centro Hospitalar do Médio Ave;59100;20799;4729;0;84628
2023-08-01;Região de Saúde Norte;Centro Hospitalar Universitário de Santo António;86292;0;13554;0;99846
2023-09-01;Região de Saúde Alentejo;Unidade Local de Saúde do Norte Alentejano;58633;6126;1916;0;66675
2023-09-01;Região de Saúde Centro;Centro Hospitalar de Leiria;100783;22888;10979;0;134650
2023-09-01;Região de Saúde Centro;Centro Hospitalar Tondela-Viseu;86598;24834;11450;0;122882
2023-09-01;Região de Saúde Centro;Unidade Local de Saúde da Guarda;60342;10897;3277;0;74516
2023-09-01;Região de Saúde LVT;Centro Hospitalar do Oeste;89716;33560;3040;0;126316
2023-09-01;Região de Saúde LVT;Hospital Professor Doutor Fernando Fonseca;132072;41983;15529;0;189584
2023-09-01;Região de Saúde Norte;Centro Hospitalar Universitário de São João;132724;57411;9970;0;200105
2023-09-01;Região de Saúde Norte;Centro Hospitalar Vila Nova de Gaia/Espinho;106748;32687;6365;0;145800
2023-09-01;Região de Saúde Norte;Hospital de Braga;115679;34175;10148;0;160002
2023-09-01;Região de Saúde Norte;Unidade Local de Saúde do Alto Minho;109063;14384;5165;0;128612
2023-10-01;Região de Saúde Alentejo;Unidade Local de Saúde do Litoral Alentejano;80972;0;0;0;80972
2023-10-01;Região de Saúde Centro;Centro Hospitalar de Leiria;111286;25526;12107;0;148919
2023-10-01;Região de Saúde Centro;Unidade Local de Saúde da Guarda;66379;12154;3623;0;82156
2023-10-01;Região de Saúde LVT;Centro Hospitalar Universitário de Lisboa Norte;117393;37337;10319;0;165049
2023-10-01;Região de Saúde Norte;Centro Hospitalar Universitário de Santo António;107717;0;17116;0;124833
2023-10-01;Região de Saúde Norte;Hospital Santa Maria Maior;45221;10216;0;0;55437
2023-11-01;Região de Saúde Centro;Centro Hospitalar de Leiria;120922;28427;12710;0;162059
2023-11-01;Região de Saúde Centro;Centro Hospitalar e Universitário de Coimbra;167532;59222;21279;0;248033
2023-11-01;Região de Saúde LVT;Centro Hospitalar Barreiro/Montijo;104686;30715;8405;0;143806
2023-11-01;Região de Saúde LVT;Centro Hospitalar de Lisboa Ocidental;83904;28122;15533;0;127559
2023-11-01;Região de Saúde Norte;Centro Hospitalar do Médio Ave;79990;29711;6651;0;116352
2023-11-01;Região de Saúde Norte;Centro Hospitalar Trás-os-Montes e Alto Douro;140391;27440;7927;0;175758
2023-11-01;Região de Saúde Norte;Hospital de Braga;139697;43070;11896;0;194663
2023-11-01;Região de Saúde Norte;Hospital Santa Maria Maior;48960;11557;0;0;60517
2023-12-01;Região de Saúde Centro;Centro Hospitalar e Universitário de Coimbra;182146;66076;23338;0;271560
2023-12-01;Região de Saúde Centro;Hospital Distrital da Figueira da Foz;52242;19736;0;0;71978
2023-12-01;Região de Saúde LVT;Centro Hospitalar Médio Tejo;118499;31037;4822;0;154358
2023-12-01;Região de Saúde Norte;Centro Hospitalar Trás-os-Montes e Alto Douro;152651;30590;8643;0;191884
2023-12-01;Região de Saúde Norte;Hospital da Senhora da Oliveira;104151;35736;11212;0;151099
2023-12-01;Região de Saúde Norte;Unidade Local de Saúde do Nordeste;101846;0;0;0;101846
2024-01-01;Região de Saúde Centro;Unidade Local de Saúde da Guarda;6762;1282;352;0;8396
2024-01-01;Região de Saúde LVT;Unidade Local de Saúde de Almada-Seixal;6831;2711;1357;0;10899
2024-01-01;Região de Saúde Norte;Unidade Local de Saúde de Barcelos/Esposende;4162;1137;0;0;5299
2024-01-01;Região de Saúde Centro;Unidade Local de Saúde de Coimbra;15443;5504;1924;0;22871
2024-01-01;Região de Saúde LVT;Unidade Local de Saúde de Loures-Odivelas;5471;2105;1430;0;9006
2024-01-01;Região de Saúde Norte;Unidade Local de Saúde de Vila Nova de Gaia/Espinho;10281;3224;662;0;14167
2024-01-01;Região de Saúde LVT;Unidade Local de Saúde do Oeste;9407;3804;506;0;13717
2024-01-01;Região de Saúde Norte;Unidade Local de Saúde do Tâmega e Sousa;10812;2333;956;0;14101
2025-01-01;Região de Saúde LVT;Unidade Local de Saúde de Amadora/Sintra;14975;4655;1395;0;21025
2025-01-01;Região de Saúde Centro;Unidade Local de Saúde de Coimbra;15076;5161;1839;0;22076
2025-01-01;Região de Saúde Norte;Unidade Local de Saúde de São João;12890;6631;1035;0;20556
2025-01-01;Região de Saúde Alentejo;Unidade Local de Saúde do Litoral Alentejano;7824;0;0;0;7824
2025-01-01;Região de Saúde Norte;Unidade Local de Saúde do Nordeste;9131;0;0;0;9131
2024-02-01;Região de Saúde LVT;Hospital de Cascais;12346;7610;2642;136;22734
2024-02-01;Região de Saúde LVT;Unidade Local de Saúde da Arrábida;10833;4853;1145;0;16831
2024-02-01;Região de Saúde LVT;Unidade Local de Saúde de Almada-Seixal;13877;6078;2750;0;22705
2024-02-01;Região de Saúde LVT;Unidade Local de Saúde de Amadora/Sintra;28032;7309;2729;0;38070
2024-02-01;Região de Saúde LVT;Unidade Local de Saúde de Lisboa Ocidental;13524;4972;2343;0;20839
2024-02-01;Região de Saúde Norte;Unidade Local de Saúde de Trás-os-Montes e Alto Douro;29116;5387;924;0;35427
2024-02-01;Região de Saúde Alentejo;Unidade Local de Saúde do Alto Alentejo;12472;1395;417;0;14284
2025-02-01;Região de Saúde Centro;Unidade Local de Saúde da Cova da Beira;7658;3483;600;70;11811
2025-02-01;Região de Saúde Centro;Unidade Local de Saúde da Região de Leiria;18873;4582;1103;0;24558
2025-02-01;Região de Saúde LVT;Unidade Local de Saúde de Amadora/Sintra;27514;8840;2465;0;38819
2025-02-01;Região de Saúde Norte;Unidade Local de Saúde de Barcelos/Esposende;8139;1567;0;0;9706
2025-02-01;Região de Saúde Alentejo;Unidade Local de Saúde do Alentejo Central;8209;3056;0;0;11265
2025-02-01;Região de Saúde Norte;Unidade Local de Saúde do Nordeste;17277;0;0;0;17277
2025-02-01;Região de Saúde LVT;Unidade Local de Saúde do Oeste;16460;6710;962;0;24132
2025-02-01;Região de Saúde Norte;Unidade Local de Saúde do Tâmega e Sousa;27335;5317;1866;0;34518
2024-03-01;Região de Saúde LVT;Unidade Local de Saúde de Amadora/Sintra;43623;12130;4016;0;59769
2024-03-01;Região de Saúde Centro;Unidade Local de Saúde de Dão-Lafões;26677;8766;3395;0;38838
2024-03-01;Região de Saúde Norte;Unidade Local de Saúde do Alto Ave;24680;9358;2365;0;36403
2024-03-01;Região de Saúde Norte;Unidade Local de Saúde do Alto Minho;33378;5763;1635;0;40776
2024-03-01;Região de Saúde Norte;Unidade Local de Saúde do Médio Ave;20894;9042;1699;0;31635
2024-04-01;Região de Saúde LVT;Unidade Local de Saúde de Lisboa Ocidental;29081;10885;4503;0;44469
2024-04-01;Região de Saúde Norte;Unidade Local de Saúde de Trás-os-Montes e Alto Douro;61592;11168;1878;0;74638
2024-04-01;Região de Saúde Alentejo;Unidade Local de Saúde do Baixo Alentejo;31199;6393;1313;0;38905
2024-04-01;Região de Saúde LVT;Unidade Local de Saúde do Estuário do Tejo;26616;16937;2524;0;46077
2024-04-01;Região de Saúde Norte;Unidade Local de Saúde do Tâmega e Sousa;49276;12830;4071;0;66177
2024-05-01;Região de Saúde LVT;Unidade Local de Saúde de Almada-Seixal;37933;17511;6955;0;62399
2024-05-01;Região de Saúde LVT;Unidade Local de Saúde de Loures-Odivelas;30081;11861;6684;0;48626
2024-05-01;Região de Saúde Norte;Unidade Local de Saúde de Vila Nova de Gaia/Espinho;53917;17961;3373;0;75251
2024-05-01;Região de Saúde LVT;Unidade Local de Saúde do Estuário do Tejo;34021;21535;3034;0;58590
2024-05-01;Região de Saúde Alentejo;Unidade Local de Saúde do Litoral Alentejano;42596;0;0;0;42596
2024-05-01;Região de Saúde Norte;Unidade Local de Saúde do Médio Ave;36239;15823;2971;0;55033
2024-06-01;Região de Saúde LVT;Hospital de Cascais;41538;24810;8129;432;74909
2024-06-01;Região de Saúde Norte;Unidade Local de Saúde de Barcelos/Esposende;26377;7721;0;0;34098
2024-06-01;Região de Saúde Centro;Unidade Local de Saúde de Dão-Lafões;56251;17116;7240;0;80607
2024-06-01;Região de Saúde Norte;Unidade Local de Saúde de Vila Nova de Gaia/Espinho;65303;20960;4047;0;90310
2024-06-01;Região de Saúde Norte;Unidade Local de Saúde do Alto Ave;51534;20238;5074;0;76846
2024-06-01;Região de Saúde Alentejo;Unidade Local de Saúde do Baixo Alentejo;48224;10011;2017;0;60252
2024-06-01;Região de Saúde LVT;Unidade Local de Saúde do Estuário do Tejo;41115;25321;3691;0;70127
2024-07-01;Região de Saúde LVT;Hospital de Cascais;48829;28379;9569;503;87280
2024-07-01;Região de Saúde Centro;Unidade Local de Saúde Castelo Branco;31858;10373;1373;0;43604
2024-07-01;Região de Saúde Norte;Unidade Local de Saúde de Braga;89494;29772;6783;0;126049
2024-07-01;Região de Saúde Centro;Unidade Local de Saúde de Dão-Lafões;66578;18964;8640;0;94182
2024-07-01;Região de Saúde Norte;Unidade Local de Saúde de Santo António;74341;0;11866;0;86207
2024-07-01;Região de Saúde Norte;Unidade Local de Saúde de Vila Nova de Gaia/Espinho;76881;23548;4715;0;105144
2024-07-01;Região de Saúde Alentejo;Unidade Local de Saúde do Alto Alentejo;47243;5461;1607;0;54311
2024-07-01;Região de Saúde Norte;Unidade Local de Saúde do Alto Minho;83601;13028;4015;0;100644
2024-08-01;Região de Saúde LVT;Unidade Local de Saúde da Arrábida;49011;20419;4838;0;74268
2024-08-01;Região de Saúde Centro;Unidade Local de Saúde da Cova da Beira;33753;11626;2707;278;48364
2024-08-01;Região de Saúde LVT;Unidade Local de Saúde da Lezíria;51684;20378;5087;0;77149
2024-08-01;Região de Saúde LVT;Unidade Local de Saúde de Almada-Seixal;61931;25867;9108;0;96906
2024-08-01;Região de Saúde Norte;Unidade Local de Saúde de Entre Douro e Vouga;109547;20164;4899;0;134610
2024-08-01;Região de Saúde LVT;Unidade Local de Saúde de Lisboa Ocidental;59950;20037;8460;0;88447
2024-08-01;Região de Saúde LVT;Unidade Local de Saúde de Santa Maria;92888;31971;3963;0;128822
2024-08-01;Região de Saúde Norte;Unidade Local de Saúde do Alto Ave;69655;24960;6893;0;101508
2024-08-01;Região de Saúde Alentejo;Unidade Local de Saúde do Litoral Alentejano;69888;0;0;0;69888
2024-08-01;Região de Saúde LVT;Unidade Local de Saúde do Médio Tejo;80253;18088;2901;0;101242
2024-09-01;Região de Saúde Centro;Unidade Local de Saúde da Região de Leiria;92561;18773;6387;0;117721
2024-09-01;Região de Saúde LVT;Unidade Local de Saúde de Amadora/Sintra;136707;36999;13744;0;187450
2024-09-01;Região de Saúde Algarve;Unidade Local de Saúde do Algarve;223081;55000;12586;0;290667
2024-09-01;Região de Saúde LVT;Unidade Local de Saúde do Arco Ribeirinho;86218;15076;5480;0;106774
2024-09-01;Região de Saúde Alentejo;Unidade Local de Saúde do Baixo Alentejo;70702;13865;3161;0;87728
2024-09-01;Região de Saúde LVT;Unidade Local de Saúde do Médio Tejo;89764;19996;3179;0;112939
2024-09-01;Região de Saúde Norte;Unidade Local de Saúde do Nordeste;79545;0;0;0;79545
2024-10-01;Região de Saúde LVT;Unidade Local de Saúde de Amadora/Sintra;152514;41891;15422;0;209827
2024-10-01;Região de Saúde Norte;Unidade Local de Saúde de Braga;127532;40229;9627;0;177388
2024-10-01;Região de Saúde Centro;Unidade Local de Saúde de Dão-Lafões;96330;24251;12496;0;133077
2024-10-01;Região de Saúde Norte;Unidade Local de Saúde de Matosinhos;69408;0;7500;0;76908
2024-10-01;Região de Saúde Norte;Unidade Local de Saúde de Vila Nova de Gaia/Espinho;111323;32488;6833;0;150644
2024-10-01;Região de Saúde Alentejo;Unidade Local de Saúde do Alentejo Central;39051;14898;0;0;53949
2024-10-01;Região de Saúde LVT;Unidade Local de Saúde do Arco Ribeirinho;95801;17854;6370;0;120025
2024-10-01;Região de Saúde Alentejo;Unidade Local de Saúde do Baixo Alentejo;78521;15383;3489;0;97393
2024-10-01;Região de Saúde LVT;Unidade Local de Saúde do Estuário do Tejo;69150;39095;6803;0;115048
2024-10-01;Região de Saúde LVT;Unidade Local de Saúde do Médio Tejo;100131;22750;3559;0;126440
2024-11-01;Região de Saúde LVT;Hospital de Cascais;82139;44457;15617;799;143012
2024-11-01;Região de Saúde Centro;Unidade Local de Saúde da Cova da Beira;45769;15657;3632;430;65488
2024-11-01;Região de Saúde Centro;Unidade Local de Saúde da Guarda;75243;14773;3620;0;93636
2024-11-01;Região de Saúde LVT;Unidade Local de Saúde de Almada-Seixal;85905;35477;11388;0;132770
2024-11-01;Região de Saúde Norte;Unidade Local de Saúde de Entre Douro e Vouga;146843;26456;6670;0;179969
2024-11-01;Região de Saúde Alentejo;Unidade Local de Saúde do Alentejo Central;43435;16326;0;0;59761
2024-11-01;Região de Saúde Alentejo;Unidade Local de Saúde do Alto Alentejo;73131;8478;2532;0;84141
2024-11-01;Região de Saúde Centro;Unidade Local de Saúde do Baixo Mondego;47148;18235;0;0;65383
2024-12-01;Região de Saúde Centro;Unidade Local de Saúde Castelo Branco;53333;16895;2376;0;72604
2024-12-01;Região de Saúde LVT;Unidade Local de Saúde da Lezíria;76960;29852;7451;0;114263
2024-12-01;Região de Saúde Alentejo;Unidade Local de Saúde do Alto Alentejo;79826;9400;2749;0;91975
2024-12-01;Região de Saúde Norte;Unidade Local de Saúde do Alto Ave;104420;37039;10324;0;151783
2019-01-01;Região de Saúde Alentejo;Hospital Espírito Santo de Évora;4553;2019;0;0;6572
2019-01-01;Região de Saúde Alentejo;Unidade Local de Saúde do Norte Alentejano;7339;797;115;0;8251
2019-01-01;Região de Saúde Algarve;Centro Hospitalar Universitário do Algarve;21191;7204;1737;0;30132
2019-01-01;Região de Saúde Centro;Centro Hospitalar do Baixo Vouga;11198;4272;603;0;16073
2019-01-01;Região de Saúde LVT;Centro Hospitalar de Lisboa Ocidental;9959;3392;1345;0;14696
2019-01-01;Região de Saúde LVT;Centro Hospitalar Médio Tejo;10447;2867;260;0;13574
2019-01-01;Região de Saúde Norte;Centro Hospitalar Entre Douro e Vouga;14767;3070;817;0;18654
2019-01-01;Região de Saúde Norte;Centro Hospitalar Póvoa de Varzim/Vila do Conde;6580;0;0;0;6580
2019-01-01;Região de Saúde Norte;Hospital Santa Maria Maior;4114;1380;0;0;5494
2019-01-01;Região de Saúde Norte;Unidade Local de Saúde de Matosinhos;6648;0;943;0;7591
2019-02-01;Região de Saúde Centro;Centro Hospitalar Universitário Cova da Beira;8464;3199;554;0;12217
2019-02-01;Região de Saúde LVT;Hospital Professor Doutor Fernando Fonseca;30017;10655;3329;0;44001
2019-02-01;Região de Saúde Norte;Centro Hospitalar Universitário do Porto;20672;0;3388;0;24060
2019-02-01;Região de Saúde Norte;Centro Hospitalar Tâmega e Sousa;23230;7305;2252;0;32787
2019-02-01;Região de Saúde Norte;Unidade Local de Saúde de Matosinhos;12809;0;1733;0;14542
2019-03-01;Região de Saúde Centro;Centro Hospitalar Universitário Cova da Beira;12811;4664;840;0;18315
2019-03-01;Região de Saúde LVT;Centro Hospitalar Médio Tejo;29253;7741;685;0;37679
2019-03-01;Região de Saúde Norte;Centro Hospitalar Universitário de São João;39864;20646;3518;0;64028
2019-03-01;Região de Saúde Norte;Centro Hospitalar do Médio Ave;23203;9513;1742;0;34458
2019-03-01;Região de Saúde Norte;Centro Hospitalar Póvoa de Varzim/Vila do Conde;18719;0;0;0;18719
2019-03-01;Região de Saúde Norte;Centro Hospitalar Trás-os-Montes e Alto Douro;37241;8167;1076;0;46484
2019-03-01;Região de Saúde Norte;Hospital da Senhora da Oliveira;24691;8836;2331;0;35858
2019-03-01;Região de Saúde Norte;Unidade Local de Saúde de Matosinhos;19350;0;2604;0;21954
2019-04-01;Região de Saúde Alentejo;Hospital Espírito Santo de Évora;17885;7049;0;0;24934
2019-04-01;Região de Saúde Centro;Centro Hospitalar de Leiria;44860;11538;4133;0;60531
2019-04-01;Região de Saúde LVT;Centro Hospitalar Médio Tejo;38398;9834;875;0;49107
2019-04-01;Região de Saúde LVT;Hospital Professor Doutor Fernando Fonseca;59847;19496;6836;0;86179
2019-04-01;Região de Saúde LVT;Hospital Garcia de Orta;33480;15404;5712;0;54596
2019-04-01;Região de Saúde Norte;Centro Hospitalar do Médio Ave;30571;11941;2304;0;44816
2019-04-01;Região de Saúde Norte;Hospital Santa Maria Maior;16291;5079;0;0;21370
2019-05-01;Região de Saúde Centro;Centro Hospitalar Universitário Cova da Beira;21264;7233;1430;0;29927
2019-05-01;Região de Saúde Centro;Centro Hospitalar do Baixo Vouga;51809;17198;2866;0;71873
2019-05-01;Região de Saúde Centro;Centro Hospitalar e Universitário de Coimbra;86159;28317;10210;0;124686
2019-05-01;Região de Saúde Norte;Centro Hospitalar do Médio Ave;38512;14827;2959;0;56298
2019-05-01;Região de Saúde Norte;Centro Hospitalar Tâmega e Sousa;58431;16206;5848;0;80485
2019-05-01;Região de Saúde Norte;Unidade Local de Saúde do Alto Minho;56601;8978;2616;0;68195
2019-06-01;Região de Saúde Alentejo;Hospital Espírito Santo de Évora;27063;10338;0;0;37401
2019-06-01;Região de Saúde Algarve;Centro Hospitalar Universitário do Algarve;126646;37703;10377;0;174726
2019-06-01;Região de Saúde Centro;Unidade Local de Saúde de Castelo Branco;25857;5717;823;0;32397
2019-06-01;Região de Saúde LVT;Centro Hospitalar Universitário Lisboa Central;70191;38356;10578;3171;122296
2019-06-01;Região de Saúde LVT;Centro Hospitalar Médio Tejo;57849;14537;1378;0;73764
2019-06-01;Região de Saúde Norte;Centro Hospitalar do Médio Ave;45956;17247;3630;0;66833
2019-06-01;Região de Saúde Norte;Centro Hospitalar Vila Nova de Gaia/Espinho;64088;21401;6132;0;91621
2019-06-01;Região de Saúde Norte;Hospital de Braga;76768;25303;8199;0;110270
2019-06-01;Região de Saúde Norte;Unidade Local de Saúde de Matosinhos;38966;0;5221;0;44187
2019-06-01;Região de Saúde Norte;Unidade Local de Saúde do Alto Minho;67394;10387;3159;0;80940
2019-07-01;Região de Saúde Centro;Centro Hospitalar Universitário Cova da Beira;29890;9452;2060;0;41402
2019-07-01;Região de Saúde Centro;Centro Hospitalar do Baixo Vouga;73601;22791;4177;0;100569
2019-07-01;Região de Saúde Centro;Unidade Local de Saúde da Guarda;47134;9099;2316;0;58549
2019-07-01;Região de Saúde LVT;Centro Hospitalar Universitário Lisboa Central;82270;43791;12433;3754;142248
2019-07-01;Região de Saúde LVT;Centro Hospitalar Universitário de Lisboa Norte;107826;26228;10927;0;144981
2019-07-01;Região de Saúde Norte;Centro Hospitalar Universitário de São João;96913;43688;8512;0;149113
2019-07-01;Região de Saúde Norte;Centro Hospitalar Universitário do Porto;75214;0;13077;0;88291
2019-08-01;Região de Saúde Alentejo;Unidade Local de Saúde do Litoral Alentejano;63062;0;0;0;63062
2019-08-01;Região de Saúde Alentejo;Unidade Local de Saúde do Norte Alentejano;54208;5370;837;0;60415
2019-08-01;Região de Saúde Centro;Centro Hospitalar do Baixo Vouga;84612;25204;4944;0;114760
2019-08-01;Região de Saúde Centro;Unidade Local de Saúde da Guarda;54636;10090;2617;0;67343
2019-08-01;Região de Saúde LVT;Hospital de Cascais;60983;33599;9780;0;104362
2019-08-01;Região de Saúde LVT;Hospital de Loures;80327;38313;12123;0;130763
2019-08-01;Região de Saúde Norte;Centro Hospitalar Universitário de São João;111413;48365;9822;0;169600
2019-08-01;Região de Saúde Norte;Centro Hospitalar Universitário do Porto;86491;0;15345;0;101836
2019-08-01;Região de Saúde Norte;Centro Hospitalar Tâmega e Sousa;95624;22893;9927;0;128444
2019-08-01;Região de Saúde Norte;Hospital Santa Maria Maior;32795;9032;0;0;41827
2019-08-01;Região de Saúde Norte;Unidade Local de Saúde de Matosinhos;52234;0;7095;0;59329
2019-08-01;Região de Saúde Norte;Unidade Local de Saúde do Nordeste;75104;0;0;0;75104
2019-09-01;Região de Saúde Alentejo;Unidade Local de Saúde do Norte Alentejano;60773;6000;982;0;67755
2019-09-01;Região de Saúde LVT;Centro Hospitalar Barreiro/Montijo;81036;26808;8363;0;116207
2019-09-01;Região de Saúde LVT;Centro Hospitalar Médio Tejo;87717;19914;2275;0;109906
2019-09-01;Região de Saúde LVT;Hospital de Cascais;69076;37692;11173;0;117941
2019-09-01;Região de Saúde Norte;Centro Hospitalar Póvoa de Varzim/Vila do Conde;54063;0;0;0;54063
2019-09-01;Região de Saúde Norte;Centro Hospitalar Trás-os-Montes e Alto Douro;113019;20210;3577;0;136806
2019-09-01;Região de Saúde Norte;Hospital da Senhora da Oliveira;74464;21243;7806;0;103513
2019-09-01;Região de Saúde Norte;Hospital Santa Maria Maior;36905;9920;0;0;46825
2019-10-01;Região de Saúde Centro;Centro Hospitalar e Universitário de Coimbra;175161;52400;21121;0;248682
2019-10-01;Região de Saúde LVT;Hospital de Loures;101147;48644;15420;0;165211
2019-10-01;Região de Saúde LVT;Hospital Professor Doutor Fernando Fonseca;151063;46579;18335;0;215977
2019-10-01;Região de Saúde Norte;Centro Hospitalar Universitário de São João;140244;61381;12468;0;214093
2019-10-01;Região de Saúde Norte;Centro Hospitalar Póvoa de Varzim/Vila do Conde;60332;0;0;0;60332
2019-10-01;Região de Saúde Norte;Hospital da Senhora da Oliveira;83133;23846;8708;0;115687
2019-11-01;Região de Saúde Alentejo;Unidade Local de Saúde do Norte Alentejano;74344;7569;1203;0;83116
2019-11-01;Região de Saúde Algarve;Centro Hospitalar Universitário do Algarve;244886;67966;19939;0;332791
2019-11-01;Região de Saúde Centro;Centro Hospitalar do Baixo Vouga;116992;35822;7013;0;159827
2019-11-01;Região de Saúde Centro;Hospital Distrital da Figueira da Foz;50135;17057;0;0;67192
2019-11-01;Região de Saúde Centro;Unidade Local de Saúde da Guarda;74269;14284;3493;0;92046
2019-11-01;Região de Saúde Norte;Centro Hospitalar Universitário do Porto;118951;0;21307;0;140258
2019-11-01;Região de Saúde Norte;Hospital da Senhora da Oliveira;91048;26843;9622;0;127513
2019-12-01;Região de Saúde Alentejo;Unidade Local de Saúde do Norte Alentejano;81143;8431;1317;0;90891
2019-12-01;Região de Saúde Centro;Centro Hospitalar Tondela-Viseu;111693;33297;15940;0;160930
2019-12-01;Região de Saúde Centro;Hospital Distrital da Figueira da Foz;54630;19305;0;0;73935
2019-12-01;Região de Saúde LVT;Centro Hospitalar Barreiro/Montijo;109263;38393;11265;0;158921
2019-12-01;Região de Saúde LVT;Hospital Distrital de Santarém;86456;37828;8362;0;132646
2019-12-01;Região de Saúde LVT;Hospital Professor Doutor Fernando Fonseca;181628;58485;22113;0;262226
2019-12-01;Região de Saúde Norte;Centro Hospitalar Universitário de São João;167646;76956;15005;0;259607
2019-12-01;Região de Saúde Norte;Centro Hospitalar Póvoa de Varzim/Vila do Conde;73626;0;0;0;73626
2019-12-01;Região de Saúde Norte;Centro Hospitalar Tâmega e Sousa;142778;36867;14913;0;194558
2019-12-01;Região de Saúde Norte;Hospital da Senhora da Oliveira;98991;30270;10514;0;139775
2019-12-01;Região de Saúde Norte;Hospital Santa Maria Maior;49480;14193;0;0;63673
2019-12-01;Região de Saúde Norte;Unidade Local de Saúde do Nordeste;112108;0;0;0;112108
2020-01-01;Região de Saúde Alentejo;Unidade Local de Saúde do Norte Alentejano;7274;871;92;0;8237
2020-01-01;Região de Saúde Centro;Centro Hospitalar Universitário Cova da Beira;4413;1341;316;0;6070
2020-01-01;Região de Saúde LVT;Centro Hospitalar Universitário Lisboa Central;11997;8114;1909;534;22554
2020-01-01;Região de Saúde LVT;Hospital Garcia de Orta;9580;3239;1565;0;14384
2020-01-01;Região de Saúde Norte;Hospital da Senhora da Oliveira;8405;2741;879;0;12025
2020-01-01;Região de Saúde Norte;Hospital Santa Maria Maior;4315;1570;0;0;5885
2020-02-01;Região de Saúde Centro;Centro Hospitalar Universitário Cova da Beira;8328;2746;587;0;11661
2020-02-01;Região de Saúde Centro;Unidade Local de Saúde de Castelo Branco;8909;2068;222;0;11199
2020-02-01;Região de Saúde LVT;Centro Hospitalar Universitário Lisboa Central;22929;15328;3576;1081;42914
2020-02-01;Região de Saúde Norte;Centro Hospitalar do Médio Ave;15363;5845;1120;0;22328
2020-02-01;Região de Saúde Norte;Centro Hospitalar Tâmega e Sousa;24543;7315;2505;0;34363
2020-03-01;Região de Saúde Alentejo;Hospital Espírito Santo de Évora;11851;4579;0;0;16430
2020-03-01;Região de Saúde Alentejo;Unidade Local de Saúde do Baixo Alentejo;20455;4016;1099;0;25570
2020-03-01;Região de Saúde Alentejo;Unidade Local de Saúde do Norte Alentejano;18032;2180;271;0;20483
2020-03-01;Região de Saúde Centro;Centro Hospitalar Tondela-Viseu;24300;7396;3500;0;35196
2020-03-01;Região de Saúde LVT;Hospital de Cascais;20656;11328;2920;0;34904
2020-03-01;Região de Saúde LVT;Hospital Distrital de Santarém;19851;8383;1847;0;30081
2020-03-01;Região de Saúde Norte;Centro Hospitalar Entre Douro e Vouga;39524;7185;2039;0;48748
2020-03-01;Região de Saúde Norte;Hospital de Braga;33150;10700;3635;0;47485
2020-04-01;Região de Saúde Algarve;Centro Hospitalar Universitário do Algarve;67833;18942;5768;0;92543
2020-04-01;Região de Saúde Centro;Centro Hospitalar de Leiria;37312;7909;3499;0;48720
2020-04-01;Região de Saúde Centro;Hospital Distrital da Figueira da Foz;13714;4294;0;0;18008
2020-04-01;Região de Saúde LVT;Centro Hospitalar Barreiro/Montijo;29835;9859;2881;0;42575
2020-04-01;Região de Saúde LVT;Centro Hospitalar Universitário Lisboa Central;36286;20538;5980;1762;64566
2020-04-01;Região de Saúde LVT;Centro Hospitalar de Lisboa Ocidental;30691;8197;4013;0;42901
2020-04-01;Região de Saúde LVT;Centro Hospitalar Médio Tejo;30100;6705;1097;0;37902
2020-04-01;Região de Saúde LVT;Hospital de Cascais;24325;12201;3609;0;40135
2020-04-01;Região de Saúde LVT;Hospital de Vila Franca de Xira;23937;12019;2890;0;38846
2020-04-01;Região de Saúde LVT;Hospital Professor Doutor Fernando Fonseca;48476;13997;5796;0;68269
2020-04-01;Região de Saúde LVT;Hospital Garcia de Orta;29034;7914;5067;0;42015
2020-04-01;Região de Saúde Norte;Centro Hospitalar Universitário do Porto;36139;0;6528;0;42667
2020-04-01;Região de Saúde Norte;Hospital Santa Maria Maior;13305;3647;0;0;16952
2020-04-01;Região de Saúde Norte;Unidade Local de Saúde do Alto Minho;34668;4955;1640;0;41263
2020-05-01;Região de Saúde Centro;Hospital Distrital da Figueira da Foz;16903;4707;0;0;21610
2020-05-01;Região de Saúde Centro;Unidade Local de Saúde de Castelo Branco;17177;2994;534;0;20705
2020-05-01;Região de Saúde LVT;Centro Hospitalar Universitário Lisboa Central;44053;22794;7203;2185;76235
2020-05-01;Região de Saúde LVT;Centro Hospitalar de Setúbal;29473;10877;4402;0;44752
2020-05-01;Região de Saúde LVT;Centro Hospitalar Universitário de Lisboa Norte;56770;12590;5728;0;75088
2020-05-01;Região de Saúde Norte;Centro Hospitalar Trás-os-Montes e Alto Douro;46152;7749;1762;0;55663
2020-06-01;Região de Saúde Alentejo;Unidade Local de Saúde do Baixo Alentejo;31960;4932;1799;0;38691
2020-06-01;Região de Saúde Alentejo;Unidade Local de Saúde do Litoral Alentejano;34432;0;0;0;34432
2020-06-01;Região de Saúde Centro;Centro Hospitalar de Leiria;53118;9590;5087;0;67795
2020-06-01;Região de Saúde Centro;Hospital Distrital da Figueira da Foz;20436;5251;0;0;25687
2020-06-01;Região de Saúde Centro;Unidade Local de Saúde da Guarda;28134;4703;2000;0;34837
2020-06-01;Região de Saúde LVT;Centro Hospitalar de Lisboa Ocidental;43855;9780;5844;0;59479
2020-06-01;Região de Saúde Norte;Centro Hospitalar do Médio Ave;36211;9294;2770;0;48275
2020-07-01;Região de Saúde Alentejo;Unidade Local de Saúde do Baixo Alentejo;37136;5471;2036;0;44643
2020-07-01;Região de Saúde Centro;Centro Hospitalar Tondela-Viseu;51516;11268;7671;0;70455
2020-07-01;Região de Saúde LVT;Centro Hospitalar Universitário Lisboa Central;60513;28463;10074;2797;101847
2020-07-01;Região de Saúde LVT;Centro Hospitalar do Oeste;51612;14763;4557;0;70932
2020-07-01;Região de Saúde LVT;Hospital Distrital de Santarém;38371;11325;3874;0;53570
2020-07-01;Região de Saúde LVT;Hospital Garcia de Orta;48474;10639;8319;0;67432
2020-07-01;Região de Saúde Norte;Centro Hospitalar Universitário de São João;81904;28179;6365;0;116448
2020-07-01;Região de Saúde Norte;Centro Hospitalar Universitário do Porto;62346;0;11924;0;74270
2020-07-01;Região de Saúde Norte;Unidade Local de Saúde de Matosinhos;39583;0;4776;0;44359
2020-07-01;Região de Saúde Norte;Unidade Local de Saúde do Nordeste;46829;0;0;0;46829
2020-08-01;Região de Saúde LVT;Centro Hospitalar Barreiro/Montijo;56215;14231;5545;0;75991
2020-08-01;Região de Saúde LVT;Centro Hospitalar de Setúbal;47186;14734;6974;0;68894
2020-08-01;Região de Saúde LVT;Hospital de Cascais;47165;18530;7346;0;73041
2020-08-01;Região de Saúde LVT;Hospital Garcia de Orta;55286;11743;9638;0;76667
2020-08-01;Região de Saúde Norte;Centro Hospitalar Universitário do Porto;71685;0;13782;0;85467
2020-08-01;Região de Saúde Norte;Hospital Santa Maria Maior;26342;4684;0;0;31026
2020-09-01;Região de Saúde Alentejo;Unidade Local de Saúde do Norte Alentejano;44460;3787;1061;0;49308
2020-09-01;Região de Saúde Centro;Centro Hospitalar Universitário Cova da Beira;29154;5654;2233;0;37041
2020-09-01;Região de Saúde LVT;Centro Hospitalar Barreiro/Montijo;63143;15898;6228;0;85269
2020-09-01;Região de Saúde LVT;Centro Hospitalar de Setúbal;52949;16633;7929;0;77511
2020-09-01;Região de Saúde LVT;Hospital de Loures;65930;22640;10010;0;98580
2020-09-01;Região de Saúde Norte;Centro Hospitalar Universitário de São João;107072;36475;8338;0;151885
2020-09-01;Região de Saúde Norte;Hospital da Senhora da Oliveira;57233;11408;6441;0;75082
2020-09-01;Região de Saúde Norte;Unidade Local de Saúde do Nordeste;60832;0;0;0;60832
2020-10-01;Região de Saúde Alentejo;Unidade Local de Saúde do Norte Alentejano;48947;4161;1168;0;54276
2020-10-01;Região de Saúde Centro;Centro Hospitalar e Universitário de Coimbra;127954;33656;17464;0;179074
2020-10-01;Região de Saúde LVT;Centro Hospitalar Barreiro/Montijo;69814;17832;6929;0;94575
2020-10-01;Região de Saúde LVT;Centro Hospitalar Universitário Lisboa Central;86039;40025;14476;4654;145194
2020-10-01;Região de Saúde LVT;Hospital de Loures;72289;25082;10992;0;108363
2020-10-01;Região de Saúde LVT;Hospital Distrital de Santarém;53111;14473;5708;0;73292
2020-10-01;Região de Saúde LVT;Hospital Garcia de Orta;68450;15075;12176;0;95701
2020-10-01;Região de Saúde Norte;Centro Hospitalar Entre Douro e Vouga;107070;13711;5773;0;126554
2020-10-01;Região de Saúde Norte;Centro Hospitalar Vila Nova de Gaia/Espinho;89813;18666;8669;0;117148
2020-10-01;Região de Saúde Norte;Hospital da Senhora da Oliveira;64139;12658;7151;0;83948
2020-10-01;Região de Saúde Norte;Unidade Local de Saúde do Nordeste;67405;0;0;0;67405
2020-11-01;Região de Saúde Alentejo;Unidade Local de Saúde do Baixo Alentejo;56425;8171;2961;0;67557
2020-11-01;Região de Saúde Centro;Centro Hospitalar Tondela-Viseu;81724;17177;12372;0;111273
2020-11-01;Região de Saúde LVT;Centro Hospitalar de Setúbal;63945;20519;9491;0;93955
2020-11-01;Região de Saúde LVT;Centro Hospitalar do Oeste;79790;21505;7128;0;108423
2020-11-01;Região de Saúde LVT;Hospital de Loures;77934;27076;11864;0;116874
2020-11-01;Região de Saúde LVT;Hospital Garcia de Orta;74032;16616;13261;0;103909
2020-11-01;Região de Saúde Norte;Centro Hospitalar Póvoa de Varzim/Vila do Conde;49233;0;0;0;49233
2020-11-01;Região de Saúde Norte;Unidade Local de Saúde de Matosinhos;63642;0;7359;0;71001
2020-12-01;Região de Saúde Centro;Centro Hospitalar do Baixo Vouga;96363;19834;5846;0;122043
2020-12-01;Região de Saúde LVT;Centro Hospitalar Barreiro/Montijo;82146;20757;8093;0;110996
2020-12-01;Região de Saúde LVT;Hospital de Cascais;69930;27604;11330;0;108864
2020-12-01;Região de Saúde LVT;Hospital de Vila Franca de Xira;68210;24356;8242;0;100808
2020-12-01;Região de Saúde Norte;Centro Hospitalar Universitário do Porto;104660;0;19794;0;124454
2020-12-01;Região de Saúde Norte;Hospital da Senhora da Oliveira;76800;14551;8302;0;99653
2021-01-01;Região de Saúde Algarve;Centro Hospitalar Universitário do Algarve;14077;2386;1357;0;17820
2021-01-01;Região de Saúde Centro;Hospital Distrital da Figueira da Foz;3132;568;0;0;3700
2021-01-01;Região de Saúde LVT;Centro Hospitalar Barreiro/Montijo;6095;1273;523;0;7891
2021-01-01;Região de Saúde LVT;Centro Hospitalar Universitário de Lisboa Norte;8508;1487;1051;0;11046
2021-01-01;Região de Saúde Norte;Centro Hospitalar Universitário do Porto;7190;0;1301;0;8491
2021-01-01;Região de Saúde Norte;Centro Hospitalar Tâmega e Sousa;9181;1288;838;0;11307
2021-01-01;Região de Saúde Norte;Hospital da Senhora da Oliveira;5782;807;595;0;7184
2021-02-01;Região de Saúde Alentejo;Hospital Espírito Santo de Évora;5735;877;0;0;6612
2021-02-01;Região de Saúde Alentejo;Unidade Local de Saúde do Baixo Alentejo;8150;1288;512;0;9950
2021-02-01;Região de Saúde Centro;Centro Hospitalar Tondela-Viseu;12574;1669;1757;0;16000
2021-02-01;Região de Saúde LVT;Centro Hospitalar de Setúbal;9986;2037;1345;0;13368
2021-02-01;Região de Saúde LVT;Centro Hospitalar do Oeste;10078;1775;1019;0;12872
2021-02-01;Região de Saúde LVT;Hospital Professor Doutor Fernando Fonseca;18927;2809;2084;0;23820
2021-02-01;Região de Saúde Norte;Centro Hospitalar do Médio Ave;10114;1517;768;0;12399
2021-02-01;Região de Saúde Norte;Hospital Santa Maria Maior;5685;427;0;0;6112
2021-03-01;Região de Saúde Alentejo;Hospital Espírito Santo de Évora;9215;1392;0;0;10607
2021-03-01;Região de Saúde Alentejo;Unidade Local de Saúde do Norte Alentejano;11198;603;295;0;12096
2021-03-01;Região de Saúde Centro;Centro Hospitalar Universitário Cova da Beira;8351;951;630;0;9932
2021-03-01;Região de Saúde Centro;Unidade Local de Saúde da Guarda;11917;1925;804;0;14646
2021-03-01;Região de Saúde LVT;Centro Hospitalar Barreiro/Montijo;16689;2872;1614;0;21175
2021-03-01;Região de Saúde LVT;Centro Hospitalar de Lisboa Ocidental;15914;2763;2472;0;21149
2021-03-01;Região de Saúde LVT;Centro Hospitalar de Setúbal;15251;3160;2100;0;20511
2021-03-01;Região de Saúde LVT;Hospital Professor Doutor Fernando Fonseca;29720;4436;3401;0;37557
2021-03-01;Região de Saúde Norte;Centro Hospitalar Tâmega e Sousa;26164;3281;2613;0;32058
2021-03-01;Região de Saúde Norte;Hospital de Braga;26948;4150;2597;0;33695
2021-03-01;Região de Saúde Norte;Hospital Santa Maria Maior;8708;681;0;0;9389
2021-04-01;Região de Saúde Alentejo;Unidade Local de Saúde do Baixo Alentejo;17655;2479;1052;0;21186
2021-04-01;Região de Saúde Algarve;Centro Hospitalar Universitário do Algarve;55497;9250;5552;0;70299
2021-04-01;Região de Saúde Centro;Centro Hospitalar de Leiria;30353;4297;2982;0;37632
2021-04-01;Região de Saúde Centro;Centro Hospitalar Tondela-Viseu;27237;4304;3971;0;35512
2021-04-01;Região de Saúde LVT;Centro Hospitalar do Oeste;23885;4748;2306;0;30939
2021-04-01;Região de Saúde LVT;Hospital Professor Doutor Fernando Fonseca;41333;7420;4742;0;53495
2021-04-01;Região de Saúde Norte;Centro Hospitalar Universitário de São João;42557;12479;3461;0;58497
2021-04-01;Região de Saúde Norte;Centro Hospitalar do Médio Ave;21734;3867;1725;0;27326
2021-04-01;Região de Saúde Norte;Centro Hospitalar Póvoa de Varzim/Vila do Conde;14920;0;0;0;14920
2021-04-01;Região de Saúde Norte;Centro Hospitalar Trás-os-Montes e Alto Douro;33511;3057;2063;0;38631
2021-04-01;Região de Saúde Norte;Centro Hospitalar Vila Nova de Gaia/Espinho;32499;5727;3046;0;41272
2021-05-01;Região de Saúde Algarve;Centro Hospitalar Universitário do Algarve;74538;13939;7048;0;95525
2021-05-01;Região de Saúde LVT;Centro Hospitalar de Lisboa Ocidental;29367;7185;4463;0;41015
2021-05-01;Região de Saúde LVT;Hospital de Cascais;25752;10341;4133;0;40226
2021-05-01;Região de Saúde Norte;Centro Hospitalar do Médio Ave;28723;5960;2246;0;36929
2021-05-01;Região de Saúde Norte;Centro Hospitalar Universitário do Porto;39769;0;7000;0;46769
2021-05-01;Região de Saúde Norte;Centro Hospitalar Póvoa de Varzim/Vila do Conde;19827;0;0;0;19827
2021-05-01;Região de Saúde Norte;Unidade Local de Saúde do Alto Minho;37201;2928;1881;0;42010
2021-06-01;Região de Saúde Algarve;Centro Hospitalar Universitário do Algarve;95068;19360;8698;0;123126
2021-06-01;Região de Saúde Centro;Centro Hospitalar Universitário Cova da Beira;19015;3273;1391;0;23679
2021-06-01;Região de Saúde Centro;Unidade Local de Saúde da Guarda;27597;4656;1748;0;34001
2021-06-01;Região de Saúde Centro;Unidade Local de Saúde de Castelo Branco;18722;3208;576;0;22506
2021-06-01;Região de Saúde LVT;Centro Hospitalar Universitário Lisboa Central;49907;25747;8247;2651;86552
2021-06-01;Região de Saúde LVT;Centro Hospitalar Universitário de Lisboa Norte;56331;12075;7280;0;75686
2021-06-01;Região de Saúde LVT;Hospital de Cascais;32698;14371;5187;0;52256
2021-06-01;Região de Saúde Norte;Centro Hospitalar Entre Douro e Vouga;63118;8032;3442;0;74592
2021-06-01;Região de Saúde Norte;Unidade Local de Saúde do Nordeste;36747;0;0;0;36747
2021-07-01;Região de Saúde Centro;Centro Hospitalar de Leiria;62648;12483;5838;0;80969
2021-07-01;Região de Saúde Centro;Hospital Distrital da Figueira da Foz;25846;6295;0;0;32141
2021-07-01;Região de Saúde LVT;Hospital Distrital de Santarém;38324;8940;3804;0;51068
2021-07-01;Região de Saúde LVT;Hospital Professor Doutor Fernando Fonseca;82985;20008;9152;0;112145
2021-07-01;Região de Saúde Norte;Unidade Local de Saúde do Nordeste;44956;0;0;0;44956
2021-08-01;Região de Saúde Alentejo;Hospital Espírito Santo de Évora;29987;7730;0;0;37717
2021-08-01;Região de Saúde Alentejo;Unidade Local de Saúde do Norte Alentejano;39331;3056;893;0;43280
2021-08-01;Região de Saúde Centro;Centro Hospitalar e Universitário de Coimbra;103096;29533;13379;0;146008
2021-08-01;Região de Saúde LVT;Hospital Garcia de Orta;53929;13981;9577;0;77487
2021-08-01;Região de Saúde Norte;Centro Hospitalar Póvoa de Varzim/Vila do Conde;37102;0;0;0;37102
2021-09-01;Região de Saúde Alentejo;Unidade Local de Saúde do Baixo Alentejo;47907;8411;2614;0;58932
2021-09-01;Região de Saúde Centro;Centro Hospitalar de Leiria;85325;16426;7805;0;109556
2021-09-01;Região de Saúde Centro;Centro Hospitalar do Baixo Vouga;80895;19726;4656;0;105277
2021-09-01;Região de Saúde Centro;Centro Hospitalar e Universitário de Coimbra;117833;34215;15250;0;167298
2021-09-01;Região de Saúde Centro;Unidade Local de Saúde de Castelo Branco;30640;5951;1040;0;37631
2021-09-01;Região de Saúde LVT;Centro Hospitalar Universitário de Lisboa Norte;93530;20178;11736;0;125444
2021-09-01;Região de Saúde LVT;Hospital de Loures;63140;23842;9782;0;96764
2021-09-01;Região de Saúde LVT;Hospital de Vila Franca de Xira;54147;20993;5821;0;80961
2021-09-01;Região de Saúde Norte;Centro Hospitalar Póvoa de Varzim/Vila do Conde;42637;0;0;0;42637
2021-09-01;Região de Saúde Norte;Hospital da Senhora da Oliveira;63448;14046;6349;0;83843
2021-09-01;Região de Saúde Norte;Hospital de Braga;100903;23439;9044;0;133386
2021-10-01;Região de Saúde Alentejo;Hospital Espírito Santo de Évora;38958;11245;0;0;50203
2021-10-01;Região de Saúde Alentejo;Unidade Local de Saúde do Norte Alentejano;51100;4370;1179;0;56649
2021-10-01;Região de Saúde Centro;Centro Hospitalar e Universitário de Coimbra;133671;40603;17077;0;191351
2021-10-01;Região de Saúde LVT;Centro Hospitalar Universitário de Lisboa Norte;107026;24192;13134;0;144352
2021-10-01;Região de Saúde LVT;Centro Hospitalar Médio Tejo;78603;16237;2961;0;97801
2021-10-01;Região de Saúde LVT;Hospital de Cascais;61262;28960;9057;0;99279
2021-10-01;Região de Saúde LVT;Hospital Professor Doutor Fernando Fonseca;125353;32444;13726;0;171523
2021-10-01;Região de Saúde Norte;Centro Hospitalar Vila Nova de Gaia/Espinho;98883;25517;8675;0;133075
2021-11-01;Região de Saúde Alentejo;Hospital Espírito Santo de Évora;43309;13068;0;0;56377
2021-11-01;Região de Saúde Alentejo;Unidade Local de Saúde do Litoral Alentejano;67609;0;0;0;67609
2021-11-01;Região de Saúde Centro;Unidade Local de Saúde da Guarda;57167;10793;3416;0;71376
2021-11-01;Região de Saúde LVT;Centro Hospitalar de Lisboa Ocidental;74985;23388;11389;0;109762
2021-11-01;Região de Saúde Norte;Centro Hospitalar Universitário do Porto;102502;0;17247;0;119749
2021-11-01;Região de Saúde Norte;Centro Hospitalar Póvoa de Varzim/Vila do Conde;55007;0;0;0;55007
2021-11-01;Região de Saúde Norte;Centro Hospitalar Tâmega e Sousa;125913;27866;11909;0;165688
2021-11-01;Região de Saúde Norte;Unidade Local de Saúde do Nordeste;78865;0;0;0;78865
2021-12-01;Região de Saúde Alentejo;Hospital Espírito Santo de Évora;47537;14629;0;0;62166
2021-12-01;Região de Saúde Alentejo;Unidade Local de Saúde do Norte Alentejano;62296;5847;1518;0;69661
2021-12-01;Região de Saúde Algarve;Centro Hospitalar Universitário do Algarve;226605;54184;18586;0;299375
2021-12-01;Região de Saúde Centro;Centro Hospitalar Universitário Cova da Beira;41954;9159;3057;491;54661
2021-12-01;Região de Saúde Centro;Centro Hospitalar do Baixo Vouga;111964;30422;6179;0;148565
2021-12-01;Região de Saúde Centro;Unidade Local de Saúde de Castelo Branco;42520;9365;1395;0;53280
2021-12-01;Região de Saúde LVT;Centro Hospitalar de Lisboa Ocidental;83115;26391;12560;0;122066
2021-12-01;Região de Saúde LVT;Centro Hospitalar de Setúbal;74250;30332;9842;0;114424
2021-12-01;Região de Saúde LVT;Hospital Distrital de Santarém;71938;20672;6796;0;99406
2021-12-01;Região de Saúde Norte;Centro Hospitalar Universitário de São João;156684;65930;12090;0;234704
2021-12-01;Região de Saúde Norte;Centro Hospitalar Universitário do Porto;112275;0;18924;0;131199
2021-12-01;Região de Saúde Norte;Hospital Santa Maria Maior;45248;8858;0;0;54106
2022-01-01;Região de Saúde Algarve;Centro Hospitalar Universitário do Algarve;18883;4448;1506;0;24837
2022-01-01;Região de Saúde Centro;Unidade Local de Saúde de Castelo Branco;3605;729;115;0;4449
2022-01-01;Região de Saúde LVT;Hospital de Cascais;6284;2928;972;0;10184
2022-01-01;Região de Saúde LVT;Hospital Distrital de Santarém;6093;1614;608;0;8315
2022-01-01;Região de Saúde Norte;Centro Hospitalar Universitário do Porto;9599;0;1609;0;11208
2022-01-01;Região de Saúde Norte;Centro Hospitalar Trás-os-Montes e Alto Douro;10889;1837;640;0;13366
2022-02-01;Região de Saúde Alentejo;Hospital Espírito Santo de Évora;8178;2695;0;0;10873
2022-02-01;Região de Saúde Alentejo;Unidade Local de Saúde do Litoral Alentejano;13021;0;0;0;13021
2022-02-01;Região de Saúde Algarve;Centro Hospitalar Universitário do Algarve;37197;9700;3034;0;49931
2022-02-01;Região de Saúde Centro;Centro Hospitalar Universitário Cova da Beira;7036;1545;542;56;9179
2022-02-01;Região de Saúde Norte;Centro Hospitalar Entre Douro e Vouga;26225;4303;1337;0;31865
2022-02-01;Região de Saúde Norte;Centro Hospitalar Tâmega e Sousa;23958;5416;2184;0;31558
2022-03-01;Região de Saúde Alentejo;Hospital Espírito Santo de Évora;12866;4926;0;0;17792
2022-03-01;Região de Saúde Alentejo;Unidade Local de Saúde do Litoral Alentejano;21029;0;0;0;21029
2022-03-01;Região de Saúde LVT;Centro Hospitalar Barreiro/Montijo;24324;9338;2323;0;35985
2022-03-01;Região de Saúde Norte;Centro Hospitalar do Médio Ave;21488;7732;1568;0;30788
2022-03-01;Região de Saúde Norte;Centro Hospitalar Tâmega e Sousa;36985;9778;3362;0;50125
2022-04-01;Região de Saúde Alentejo;Unidade Local de Saúde do Litoral Alentejano;28318;0;0;0;28318
2022-04-01;Região de Saúde Algarve;Centro Hospitalar Universitário do Algarve;81307;22154;6310;0;109771
2022-04-01;Região de Saúde Centro;Centro Hospitalar de Leiria;42911;10874;3732;0;57517
2022-04-01;Região de Saúde LVT;Centro Hospitalar Universitário Lisboa Central;42920;27443;6108;2064;78535
2022-04-01;Região de Saúde LVT;Centro Hospitalar Médio Tejo;36325;10432;1327;0;48084
2022-04-01;Região de Saúde LVT;Hospital Distrital de Santarém;26860;9292;2468;0;38620
2022-04-01;Região de Saúde LVT;Hospital Garcia de Orta;29302;15238;5305;0;49845
2022-04-01;Região de Saúde Norte;Centro Hospitalar Trás-os-Montes e Alto Douro;45952;9752;2380;0;58084
2022-04-01;Região de Saúde Norte;Hospital da Senhora da Oliveira;32323;11227;3062;0;46612
2022-04-01;Região de Saúde Norte;Hospital Santa Maria Maior;16348;4218;0;0;20566
2022-05-01;Região de Saúde Alentejo;Unidade Local de Saúde do Norte Alentejano;29341;3826;929;0;34096
2022-05-01;Região de Saúde Algarve;Centro Hospitalar Universitário do Algarve;106631;29599;8072;0;144302
2022-05-01;Região de Saúde Centro;Centro Hospitalar e Universitário de Coimbra;75084;29765;9022;0;113871
2022-05-01;Região de Saúde LVT;Hospital de Loures;39631;22326;5276;0;67233
2022-05-01;Região de Saúde Norte;Centro Hospitalar Universitário de São João;69170;34872;5326;0;109368
2022-05-01;Região de Saúde Norte;Centro Hospitalar Entre Douro e Vouga;74088;14862;3594;0;92544
2022-05-01;Região de Saúde Norte;Hospital da Senhora da Oliveira;41844;14270;3940;0;60054
2022-05-01;Região de Saúde Norte;Unidade Local de Saúde de Matosinhos;34990;0;3737;0;38727
2022-05-01;Região de Saúde Norte;Unidade Local de Saúde do Alto Minho;53301;7697;2307;0;63305
2022-06-01;Região de Saúde Alentejo;Hospital Espírito Santo de Évora;26398;10563;0;0;36961
2022-06-01;Região de Saúde Centro;Unidade Local de Saúde da Guarda;36245;7238;1938;0;45421
2022-06-01;Região de Saúde Centro;Unidade Local de Saúde de Castelo Branco;24363;6874;770;0;32007
2022-06-01;Região de Saúde LVT;Centro Hospitalar Universitário Lisboa Central;67296;41270;9614;3244;121424
2022-06-01;Região de Saúde LVT;Centro Hospitalar do Oeste;56096;23000;4047;0;83143
2022-07-01;Região de Saúde Alentejo;Hospital Espírito Santo de Évora;31078;12066;0;0;43144
2022-07-01;Região de Saúde Alentejo;Unidade Local de Saúde do Norte Alentejano;41213;4999;1323;0;47535
2022-07-01;Região de Saúde Centro;Hospital Distrital da Figueira da Foz;30979;10681;0;0;41660
2022-07-01;Região de Saúde LVT;Centro Hospitalar Barreiro/Montijo;60144;21588;5606;0;87338
2022-07-01;Região de Saúde LVT;Hospital Distrital de Santarém;48753;17054;4501;0;70308
2022-07-01;Região de Saúde Norte;Centro Hospitalar do Médio Ave;52767;18082;3805;0;74654
2022-07-01;Região de Saúde Norte;Hospital Santa Maria Maior;30271;7966;0;0;38237
2022-07-01;Região de Saúde Norte;Unidade Local de Saúde do Alto Minho;76830;10722;3372;0;90924
2022-08-01;Região de Saúde Centro;Centro Hospitalar do Baixo Vouga;85862;26516;4136;0;116514
2022-08-01;Região de Saúde Centro;Unidade Local de Saúde de Castelo Branco;33183;8844;1073;0;43100
2022-08-01;Região de Saúde LVT;Centro Hospitalar do Oeste;75824;29276;5550;0;110650
2022-08-01;Região de Saúde LVT;Centro Hospitalar Universitário de Lisboa Norte;100386;26011;11918;0;138315
2022-08-01;Região de Saúde Norte;Centro Hospitalar Tâmega e Sousa;101767;25008;9500;0;136275
2022-08-01;Região de Saúde Norte;Hospital da Senhora da Oliveira;67347;20958;6887;0;95192
2022-08-01;Região de Saúde Norte;Unidade Local de Saúde do Nordeste;68360;0;0;0;68360
2022-09-01;Região de Saúde Alentejo;Unidade Local de Saúde do Norte Alentejano;52922;5976;1769;0;60667
2022-09-01;Região de Saúde LVT;Hospital de Loures;70364;36729;9846;0;116939
2022-09-01;Região de Saúde Norte;Centro Hospitalar Vila Nova de Gaia/Espinho;100719;31467;6187;0;138373
2022-09-01;Região de Saúde Norte;Hospital Santa Maria Maior;38914;9539;0;0;48453
2022-09-01;Região de Saúde Norte;Unidade Local de Saúde do Nordeste;75964;0;0;0;75964
2022-10-01;Região de Saúde Alentejo;Unidade Local de Saúde do Baixo Alentejo;67213;14883;3060;0;85156
2022-10-01;Região de Saúde LVT;Centro Hospitalar do Oeste;94833;38254;7021;0;140108
2022-10-01;Região de Saúde LVT;Centro Hospitalar Universitário de Lisboa Norte;125518;33664;14866;0;174048
2022-10-01;Região de Saúde LVT;Hospital de Loures;78224;42852;10928;0;132004
2022-10-01;Região de Saúde Norte;Centro Hospitalar Trás-os-Montes e Alto Douro;122870;23763;6644;0;153277
2022-11-01;Região de Saúde Centro;Centro Hospitalar Universitário Cova da Beira;44165;13117;3469;440;61191
2022-11-01;Região de Saúde Centro;Centro Hospitalar do Baixo Vouga;118589;39611;5869;0;164069
2022-11-01;Região de Saúde Centro;Centro Hospitalar e Universitário de Coimbra;167323;65255;20802;0;253380
2022-11-01;Região de Saúde Centro;Unidade Local de Saúde da Guarda;68796;13866;3704;0;86366
2022-11-01;Região de Saúde Centro;Unidade Local de Saúde de Castelo Branco;45744;13243;1510;0;60497
2022-11-01;Região de Saúde Norte;Centro Hospitalar Tâmega e Sousa;138751;36287;13272;0;188310
2022-11-01;Região de Saúde Norte;Unidade Local de Saúde de Matosinhos;77283;0;8841;0;86124
2022-11-01;Região de Saúde Norte;Unidade Local de Saúde do Nordeste;93835;0;0;0;93835
2022-12-01;Região de Saúde Alentejo;Unidade Local de Saúde do Norte Alentejano;72461;8804;2356;0;83621
2022-12-01;Região de Saúde Centro;Centro Hospitalar Tondela-Viseu;110050;36157;15353;0;161560
2022-12-01;Região de Saúde Centro;Unidade Local de Saúde da Guarda;75853;15593;4020;0;95466
2022-12-01;Região de Saúde Centro;Unidade Local de Saúde de Castelo Branco;50205;14644;1657;0;66506
2022-12-01;Região de Saúde LVT;Centro Hospitalar de Setúbal;83089;43007;10320;0;136416
2022-12-01;Região de Saúde LVT;Hospital de Cascais;89889;52966;12830;0;155685
2022-12-01;Região de Saúde LVT;Hospital Distrital de Santarém;83579;33147;7976;0;124702
2022-12-01;Região de Saúde Norte;Centro Hospitalar do Médio Ave;89763;32733;6648;0;129144
2022-12-01;Região de Saúde Norte;Hospital de Braga;144165;45756;12993;0;202914
2023-01-01;Região de Saúde Centro;Centro Hospitalar Universitário Cova da Beira;4207;1381;355;32;5975
2023-01-01;Região de Saúde Centro;Centro Hospitalar Tondela-Viseu;9230;3081;1309;0;13620
2023-01-01;Região de Saúde LVT;Centro Hospitalar Barreiro/Montijo;9526;3656;791;0;13973
2023-01-01;Região de Saúde LVT;Hospital Professor Doutor Fernando Fonseca;14768;5219;1755;0;21742
2023-01-01;Região de Saúde LVT;Hospital Garcia de Orta;6768;4045;1558;0;12371
2023-01-01;Região de Saúde Norte;Hospital Santa Maria Maior;4378;1251;0;0;5629
2023-01-01;Região de Saúde Norte;Unidade Local de Saúde de Matosinhos;6723;0;679;0;7402
2023-02-01;Região de Saúde Alentejo;Unidade Local de Saúde do Litoral Alentejano;15497;0;0;0;15497
2023-02-01;Região de Saúde Centro;Unidade Local de Saúde de Castelo Branco;8447;2478;262;0;11187
2023-02-01;Região de Saúde LVT;Centro Hospitalar do Oeste;18256;8254;1154;0;27664
2023-02-01;Região de Saúde Norte;Centro Hospitalar Trás-os-Montes e Alto Douro;23975;5298;1187;0;30460
2023-02-01;Região de Saúde Norte;Unidade Local de Saúde de Matosinhos;12814;0;1423;0;14237
2023-02-01;Região de Saúde Norte;Unidade Local de Saúde do Nordeste;16271;0;0;0;16271
2023-03-01;Região de Saúde Centro;Centro Hospitalar de Leiria;31802;8421;3108;0;43331
2023-03-01;Região de Saúde LVT;Centro Hospitalar do Oeste;28200;12766;1779;0;42745
2023-03-01;Região de Saúde LVT;Hospital Garcia de Orta;20438;12464;4548;0;37450
2023-03-01;Região de Saúde Norte;Centro Hospitalar Entre Douro e Vouga;46046;9365;2056;0;57467
2023-03-01;Região de Saúde Norte;Centro Hospitalar Póvoa de Varzim/Vila do Conde;17979;0;0;0;17979
2023-03-01;Região de Saúde Norte;Centro Hospitalar Tâmega e Sousa;37792;9953;3579;0;51324
2023-03-01;Região de Saúde Norte;Centro Hospitalar Universitário de Santo António;30640;0;4866;0;35506
2023-03-01;Região de Saúde Norte;Hospital de Braga;36168;12134;3247;0;51549
2023-04-01;Região de Saúde Alentejo;Unidade Local de Saúde do Norte Alentejano;25380;2946;760;0;29086
2023-04-01;Região de Saúde Centro;Centro Hospitalar Tondela-Viseu;36085;11723;4817;0;52625
2023-04-01;Região de Saúde LVT;Centro Hospitalar de Setúbal;25121;11937;2937;0;39995
2023-04-01;Região de Saúde LVT;Hospital Garcia de Orta;27318;16269;6041;0;49628
2023-04-01;Região de Saúde Norte;Hospital Santa Maria Maior;17477;4647;0;0;22124
2023-05-01;Região de Saúde Centro;Centro Hospitalar Universitário Cova da Beira;20392;6436;1636;197;28661
2023-05-01;Região de Saúde Centro;Centro Hospitalar de Leiria;54219;13711;5378;0;73308
2023-05-01;Região de Saúde Centro;Centro Hospitalar do Baixo Vouga;54545;18572;2809;0;75926
2023-05-01;Região de Saúde Norte;Hospital da Senhora da Oliveira;40570;14120;4077;0;58767
2023-05-01;Região de Saúde Norte;Unidade Local de Saúde de Matosinhos;33956;0;3875;0;37831
2023-05-01;Região de Saúde Norte;Unidade Local de Saúde do Alto Minho;57871;8931;2621;0;69423
2023-06-01;Região de Saúde Centro;Unidade Local de Saúde da Guarda;38413;7966;2032;0;48411
2023-06-01;Região de Saúde Centro;Unidade Local de Saúde de Castelo Branco;26274;7980;879;0;35133
2023-06-01;Região de Saúde LVT;Centro Hospitalar de Setúbal;38149;17914;4685;0;60748
2023-06-01;Região de Saúde LVT;Centro Hospitalar Universitário de Lisboa Norte;70140;23497;8994;0;102631
2023-06-01;Região de Saúde LVT;Hospital de Cascais;45059;25072;6712;0;76843
2023-06-01;Região de Saúde LVT;Hospital de Loures;40802;19101;6592;0;66495
2023-06-01;Região de Saúde LVT;Hospital Distrital de Santarém;41258;15901;3839;0;60998
2023-06-01;Região de Saúde Norte;Centro Hospitalar Entre Douro e Vouga;92581;17952;4303;0;114836
2023-06-01;Região de Saúde Norte;Centro Hospitalar Póvoa de Varzim/Vila do Conde;35688;0;0;0;35688
2023-06-01;Região de Saúde Norte;Unidade Local de Saúde de Matosinhos;40936;0;4665;0;45601
2023-07-01;Região de Saúde Centro;Centro Hospitalar de Leiria;77005;18365;8269;0;103639
2023-07-01;Região de Saúde Centro;Hospital Distrital da Figueira da Foz;30305;11264;0;0;41569
2023-07-01;Região de Saúde Centro;Unidade Local de Saúde da Guarda;45552;8935;2434;0;56921
2023-07-01;Região de Saúde LVT;Hospital Distrital de Santarém;48343;18367;4506;0;71216
2023-07-01;Região de Saúde Norte;Hospital da Senhora da Oliveira;61239;20259;6200;0;87698
2023-07-01;Região de Saúde Norte;Unidade Local de Saúde do Alto Minho;82334;11687;3881;0;97902
2023-08-01;Região de Saúde Alentejo;Unidade Local de Saúde do Baixo Alentejo;60724;11619;2700;0;75043
2023-08-01;Região de Saúde Alentejo;Unidade Local de Saúde do Litoral Alentejano;65620;0;0;0;65620
2023-08-01;Região de Saúde Centro;Centro Hospitalar Universitário Cova da Beira;33719;9732;2704;270;46425
2023-08-01;Região de Saúde Centro;Centro Hospitalar de Leiria;89840;20739;9633;0;120212
2023-08-01;Região de Saúde LVT;Centro Hospitalar de Lisboa Ocidental;62309;20155;9620;0;92084
2023-08-01;Região de Saúde LVT;Hospital de Loures;54600;21861;9162;0;85623
2023-08-01;Região de Saúde Norte;Centro Hospitalar Universitário de São João;118565;51516;8831;0;178912
2023-09-01;Região de Saúde Alentejo;Hospital Espírito Santo de Évora;39169;12815;0;0;51984
2023-09-01;Região de Saúde LVT;Centro Hospitalar Universitário Lisboa Central;102665;57593;17797;4785;182840
2023-09-01;Região de Saúde LVT;Centro Hospitalar Médio Tejo;89668;23291;3588;0;116547
2023-09-01;Região de Saúde LVT;Hospital de Cascais;68827;35031;10590;0;114448
2023-09-01;Região de Saúde LVT;Hospital de Vila Franca de Xira;61204;32740;6524;0;100468
2023-09-01;Região de Saúde Norte;Centro Hospitalar Póvoa de Varzim/Vila do Conde;52994;0;0;0;52994
2023-09-01;Região de Saúde Norte;Centro Hospitalar Tâmega e Sousa;118413;26707;11774;0;156894
2023-09-01;Região de Saúde Norte;Centro Hospitalar Trás-os-Montes e Alto Douro;117386;22111;6503;0;146000
2023-09-01;Região de Saúde Norte;Unidade Local de Saúde do Nordeste;76756;0;0;0;76756
2023-10-01;Região de Saúde Algarve;Centro Hospitalar Universitário do Algarve;242500;57464;15623;0;315587
2023-10-01;Região de Saúde Centro;Centro Hospitalar Universitário Cova da Beira;42011;12101;3410;316;57838
2023-10-01;Região de Saúde Centro;Unidade Local de Saúde de Castelo Branco;43984;12178;1526;0;57688
2023-10-01;Região de Saúde LVT;Hospital de Cascais;75358;39479;12614;0;127451
2023-10-01;Região de Saúde Norte;Centro Hospitalar Universitário de São João;147080;64770;11138;0;222988
2023-10-01;Região de Saúde Norte;Hospital de Braga;128165;38403;11206;0;177774
2023-10-01;Região de Saúde Norte;Unidade Local de Saúde do Alto Minho;120881;16290;5806;0;142977
2023-11-01;Região de Saúde Alentejo;Unidade Local de Saúde do Norte Alentejano;71297;7457;2298;0;81052
2023-11-01;Região de Saúde Algarve;Centro Hospitalar Universitário do Algarve;264330;64058;17054;0;345442
2023-11-01;Região de Saúde LVT;Centro Hospitalar do Oeste;108596;41897;3419;0;153912
2023-11-01;Região de Saúde LVT;Centro Hospitalar Médio Tejo;108252;27971;4422;0;140645
2023-11-01;Região de Saúde LVT;Hospital de Vila Franca de Xira;74370;42264;7960;0;124594
2023-11-01;Região de Saúde LVT;Hospital Distrital de Santarém;73943;28855;7008;0;109806
2023-11-01;Região de Saúde LVT;Hospital Garcia de Orta;79462;42976;15868;0;138306
2023-11-01;Região de Saúde Norte;Centro Hospitalar Universitário de São João;160123;73217;12354;0;245694
2023-11-01;Região de Saúde Norte;Centro Hospitalar Tâmega e Sousa;141044;32174;13542;0;186760
2023-11-01;Região de Saúde Norte;Unidade Local de Saúde do Alto Minho;132271;18128;6431;0;156830
2023-11-01;Região de Saúde Norte;Unidade Local de Saúde do Nordeste;92887;0;0;0;92887
2023-12-01;Região de Saúde Alentejo;Unidade Local de Saúde do Litoral Alentejano;97088;0;0;0;97088
2023-12-01;Região de Saúde Centro;Centro Hospitalar Universitário Cova da Beira;50406;15270;4090;421;70187
2023-12-01;Região de Saúde Centro;Centro Hospitalar do Baixo Vouga;131126;42699;6914;0;180739
2023-12-01;Região de Saúde Centro;Unidade Local de Saúde da Guarda;78478;15301;4157;0;97936
2023-12-01;Região de Saúde Centro;Unidade Local de Saúde de Castelo Branco;52503;15238;1866;0;69607
2023-12-01;Região de Saúde LVT;Centro Hospitalar de Lisboa Ocidental;90796;31155;17133;0;139084
2023-12-01;Região de Saúde LVT;Hospital de Vila Franca de Xira;80987;46902;8663;0;136552
2023-12-01;Região de Saúde LVT;Hospital Professor Doutor Fernando Fonseca;175814;56580;18825;0;251219
2023-12-01;Região de Saúde Norte;Centro Hospitalar Entre Douro e Vouga;184442;35160;8621;0;228223
2024-01-01;Região de Saúde LVT;Hospital de Cascais;5910;3559;1338;73;10880
2024-01-01;Região de Saúde Centro;Unidade Local de Saúde da Região de Aveiro;9435;3589;470;0;13494
2024-01-01;Região de Saúde Centro;Unidade Local de Saúde de Dão-Lafões;8917;3077;1110;0;13104
2024-01-01;Região de Saúde LVT;Unidade Local de Saúde de São José;10366;6734;1935;489;19524
2024-01-01;Região de Saúde Alentejo;Unidade Local de Saúde do Alentejo Central;3582;1159;0;0;4741
2024-01-01;Região de Saúde Alentejo;Unidade Local de Saúde do Baixo Alentejo;7970;1582;332;0;9884
2024-01-01;Região de Saúde Alentejo;Unidade Local de Saúde do Litoral Alentejano;8222;0;0;0;8222
2024-01-01;Região de Saúde Norte;Unidade Local de Saúde do Médio Ave;6824;2592;560;0;9976
2024-01-01;Região de Saúde Norte;Unidade Local de Saúde do Nordeste;8927;0;0;0;8927
2025-01-01;Região de Saúde LVT;Hospital de Cascais;7169;3836;1210;56;12271
2025-01-01;Região de Saúde LVT;Unidade Local de Saúde da Arrábida;6778;3194;568;0;10540
2025-01-01;Região de Saúde LVT;Unidade Local de Saúde de Almada-Seixal;7108;2880;1051;0;11039
2025-01-01;Região de Saúde Norte;Unidade Local de Saúde de Barcelos/Esposende;4111;751;0;0;4862
2025-01-01;Região de Saúde Norte;Unidade Local de Saúde de Matosinhos;6206;0;615;0;6821
2025-01-01;Região de Saúde LVT;Unidade Local de Saúde do Médio Tejo;9938;2790;258;0;12986
2025-01-01;Região de Saúde LVT;Unidade Local de Saúde do Oeste;8378;3340;502;0;12220
2024-02-01;Região de Saúde LVT;Unidade Local de Saúde do Arco Ribeirinho;18486;3512;1267;0;23265
2024-02-01;Região de Saúde LVT;Unidade Local de Saúde do Médio Tejo;17351;4224;623;0;22198
2024-02-01;Região de Saúde Norte;Unidade Local de Saúde do Nordeste;16699;0;0;0;16699
2024-02-01;Região de Saúde LVT;Unidade Local de Saúde do Oeste;18343;7933;954;0;27230
2025-02-01;Região de Saúde LVT;Unidade Local de Saúde da Arrábida;13080;6383;1015;0;20478
2025-02-01;Região de Saúde Centro;Unidade Local de Saúde de Coimbra;28916;9473;3436;0;41825
2025-02-01;Região de Saúde LVT;Unidade Local de Saúde de Lisboa Ocidental;15023;5295;2337;0;22655
2025-02-01;Região de Saúde LVT;Unidade Local de Saúde de Loures-Odivelas;10667;3775;1927;0;16369
2025-02-01;Região de Saúde LVT;Unidade Local de Saúde de Santa Maria;18961;7440;2441;0;28842
2025-02-01;Região de Saúde Norte;Unidade Local de Saúde de São João;25335;13211;2097;0;40643
2025-02-01;Região de Saúde Algarve;Unidade Local de Saúde do Algarve;45800;12938;1993;0;60731
2025-02-01;Região de Saúde Norte;Unidade Local de Saúde do Alto Ave;16195;4854;1533;0;22582
2025-02-01;Região de Saúde LVT;Unidade Local de Saúde do Estuário do Tejo;11787;7674;979;0;20440
2025-02-01;Região de Saúde Norte;Unidade Local de Saúde do Médio Ave;12600;3902;1094;0;17596
2024-03-01;Região de Saúde LVT;Hospital de Cascais;19425;12137;3983;218;35763
2024-03-01;Região de Saúde LVT;Unidade Local de Saúde da Arrábida;17144;7622;1765;0;26531
2024-03-01;Região de Saúde Centro;Unidade Local de Saúde da Guarda;19158;3979;945;0;24082
2024-03-01;Região de Saúde Centro;Unidade Local de Saúde da Região de Aveiro;29433;12001;1416;0;42850
2024-03-01;Região de Saúde LVT;Unidade Local de Saúde de Almada-Seixal;21579;9672;4140;0;35391
2024-03-01;Região de Saúde Norte;Unidade Local de Saúde de Barcelos/Esposende;12732;3877;0;0;16609
2024-03-01;Região de Saúde Centro;Unidade Local de Saúde de Coimbra;48106;17363;5631;0;71100
2024-03-01;Região de Saúde LVT;Unidade Local de Saúde de Loures-Odivelas;17441;6985;4136;0;28562
2024-03-01;Região de Saúde LVT;Unidade Local de Saúde de Santa Maria;31897;12377;420;0;44694
2024-03-01;Região de Saúde Norte;Unidade Local de Saúde de Vila Nova de Gaia/Espinho;31281;10944;2036;0;44261
2024-03-01;Região de Saúde Alentejo;Unidade Local de Saúde do Alentejo Central;11259;3782;0;0;15041
2024-03-01;Região de Saúde LVT;Unidade Local de Saúde do Estuário do Tejo;19490;12751;2074;0;34315
2024-03-01;Região de Saúde Norte;Unidade Local de Saúde do Nordeste;25369;0;0;0;25369
2024-03-01;Região de Saúde Norte;Unidade Local de Saúde do Tâmega e Sousa;35605;9267;2981;0;47853
2024-04-01;Região de Saúde LVT;Unidade Local de Saúde da Arrábida;23436;10475;2476;0;36387
2024-04-01;Região de Saúde Centro;Unidade Local de Saúde da Região de Leiria;40745;10130;3138;0;54013
2024-04-01;Região de Saúde LVT;Unidade Local de Saúde de Amadora/Sintra;59730;16966;5630;0;82326
2024-04-01;Região de Saúde Centro;Unidade Local de Saúde de Coimbra;65495;23547;7650;0;96692
2024-04-01;Região de Saúde Norte;Unidade Local de Saúde de Entre Douro e Vouga;57292;11700;2500;0;71492
2024-04-01;Região de Saúde Norte;Unidade Local de Saúde de Santo António;41169;0;6667;0;47836
2024-04-01;Região de Saúde LVT;Unidade Local de Saúde de São José;43741;28989;8217;2057;83004
2024-04-01;Região de Saúde Algarve;Unidade Local de Saúde do Algarve;90126;24784;5766;0;120676
2024-04-01;Região de Saúde Norte;Unidade Local de Saúde do Médio Ave;28460;12169;2297;0;42926
2024-04-01;Região de Saúde LVT;Unidade Local de Saúde do Oeste;38640;17746;1986;0;58372
2024-05-01;Região de Saúde Centro;Unidade Local de Saúde da Região de Leiria;51469;12454;3975;0;67898
2024-05-01;Região de Saúde Norte;Unidade Local de Saúde de Barcelos/Esposende;21831;6536;0;0;28367
2024-05-01;Região de Saúde LVT;Unidade Local de Saúde de Lisboa Ocidental;37458;13868;5563;0;56889
2024-05-01;Região de Saúde Norte;Unidade Local de Saúde de Matosinhos;34334;0;3574;0;37908
2024-05-01;Região de Saúde Norte;Unidade Local de Saúde de Santo António;52486;0;8465;0;60951
2024-05-01;Região de Saúde Alentejo;Unidade Local de Saúde do Alto Alentejo;33018;3977;1096;0;38091
2024-05-01;Região de Saúde LVT;Unidade Local de Saúde do Oeste;49305;22746;2559;0;74610
2024-05-01;Região de Saúde Norte;Unidade Local de Saúde do Tâmega e Sousa;63026;16684;5189;0;84899
2024-06-01;Região de Saúde Centro;Unidade Local de Saúde da Cova da Beira;25078;9221;1967;199;36465
2024-06-01;Região de Saúde Centro;Unidade Local de Saúde da Guarda;40722;8708;1926;0;51356
2024-06-01;Região de Saúde Centro;Unidade Local de Saúde da Região de Leiria;61782;14375;4589;0;80746
2024-06-01;Região de Saúde LVT;Unidade Local de Saúde de Lisboa Ocidental;44901;16234;6483;0;67618
2024-06-01;Região de Saúde Norte;Unidade Local de Saúde de Matosinhos;41316;0;4334;0;45650
2024-06-01;Região de Saúde Norte;Unidade Local de Saúde de São João;85412;43212;6361;0;134985
2024-06-01;Região de Saúde Norte;Unidade Local de Saúde de Trás-os-Montes e Alto Douro;96366;17034;2729;0;116129
2024-06-01;Região de Saúde Algarve;Unidade Local de Saúde do Algarve;141489;38062;8196;0;187747
2024-06-01;Região de Saúde Centro;Unidade Local de Saúde do Baixo Mondego;25546;10792;0;0;36338
2024-06-01;Região de Saúde Alentejo;Unidade Local de Saúde do Litoral Alentejano;51345;0;0;0;51345
2024-06-01;Região de Saúde LVT;Unidade Local de Saúde do Oeste;59295;26884;3212;0;89391
2024-07-01;Região de Saúde Norte;Unidade Local de Saúde da Póvoa de Varzim/Vila do Conde;39915;0;0;0;39915
2024-07-01;Região de Saúde Centro;Unidade Local de Saúde da Região de Aveiro;73219;28077;3604;0;104900
2024-07-01;Região de Saúde LVT;Unidade Local de Saúde de Amadora/Sintra;106511;30237;10487;0;147235
2024-07-01;Região de Saúde LVT;Unidade Local de Saúde de Lisboa Ocidental;52616;18370;7585;0;78571
2024-07-01;Região de Saúde Alentejo;Unidade Local de Saúde do Alentejo Central;26859;11165;0;0;38024
2024-07-01;Região de Saúde Norte;Unidade Local de Saúde do Alto Ave;60856;22899;5997;0;89752
2024-07-01;Região de Saúde LVT;Unidade Local de Saúde do Arco Ribeirinho;67767;12274;4200;0;84241
2024-07-01;Região de Saúde Norte;Unidade Local de Saúde do Tâmega e Sousa;90880;22874;7486;0;121240
2024-08-01;Região de Saúde Centro;Unidade Local de Saúde Castelo Branco;36585;11509;1560;0;49654
2024-08-01;Região de Saúde Centro;Unidade Local de Saúde da Guarda;55658;10995;2733;0;69386
2024-08-01;Região de Saúde Centro;Unidade Local de Saúde da Região de Aveiro;83501;31074;4240;0;118815
2024-08-01;Região de Saúde Norte;Unidade Local de Saúde de Barcelos/Esposende;35753;9647;0;0;45400
2024-08-01;Região de Saúde LVT;Unidade Local de Saúde de Loures-Odivelas;47833;16192;10081;0;74106
2024-08-01;Região de Saúde Norte;Unidade Local de Saúde de São João;115457;53890;8560;0;177907
2024-09-01;Região de Saúde LVT;Unidade Local de Saúde da Arrábida;55459;22668;5576;0;83703
2024-09-01;Região de Saúde Centro;Unidade Local de Saúde da Cova da Beira;37663;12591;3010;361;53625
2024-09-01;Região de Saúde LVT;Unidade Local de Saúde da Lezíria;57878;22496;5723;0;86097
2024-09-01;Região de Saúde LVT;Unidade Local de Saúde de Lisboa Ocidental;67510;22099;9329;0;98938
2024-09-01;Região de Saúde LVT;Unidade Local de Saúde de São José;102580;61019;18508;4754;186861
2024-09-01;Região de Saúde Alentejo;Unidade Local de Saúde do Alentejo Central;34655;13519;0;0;48174
2024-09-01;Região de Saúde Norte;Unidade Local de Saúde do Alto Ave;78032;27297;7761;0;113090
2024-09-01;Região de Saúde Norte;Unidade Local de Saúde do Alto Minho;109079;15830;5264;0;130173
2024-09-01;Região de Saúde LVT;Unidade Local de Saúde do Estuário do Tejo;61916;34475;6072;0;102463
2024-09-01;Região de Saúde Norte;Unidade Local de Saúde do Médio Ave;65126;24642;5382;0;95150
2024-09-01;Região de Saúde Norte;Unidade Local de Saúde do Tâmega e Sousa;120383;27550;9770;0;157703
2024-10-01;Região de Saúde Centro;Unidade Local de Saúde da Guarda;68761;13480;3310;0;85551
2024-10-01;Região de Saúde LVT;Unidade Local de Saúde de Almada-Seixal;78133;32076;10551;0;120760
2024-10-01;Região de Saúde Norte;Unidade Local de Saúde de Barcelos/Esposende;44122;11161;0;0;55283
2024-10-01;Região de Saúde LVT;Unidade Local de Saúde do Oeste;99809;41571;5435;0;146815
2024-11-01;Região de Saúde Centro;Unidade Local de Saúde Castelo Branco;49049;15183;2182;0;66414
2024-11-01;Região de Saúde LVT;Unidade Local de Saúde da Lezíria;70707;26981;6861;0;104549
2024-11-01;Região de Saúde Centro;Unidade Local de Saúde da Região de Aveiro;113884;42825;6064;0;162773
2024-11-01;Região de Saúde Centro;Unidade Local de Saúde da Região de Leiria;112529;22555;7663;0;142747
2024-11-01;Região de Saúde Norte;Unidade Local de Saúde de Barcelos/Esposende;48270;12199;0;0;60469
2024-11-01;Região de Saúde LVT;Unidade Local de Saúde de Lisboa Ocidental;83162;28062;11197;0;122421
2024-11-01;Região de Saúde Norte;Unidade Local de Saúde de Matosinhos;76255;0;8221;0;84476
2024-11-01;Região de Saúde LVT;Unidade Local de Saúde de Santa Maria;127152;44944;7553;0;179649
2024-11-01;Região de Saúde Algarve;Unidade Local de Saúde do Algarve;268869;66223;15479;0;350571
2024-11-01;Região de Saúde LVT;Unidade Local de Saúde do Estuário do Tejo;68815;43992;7347;0;120154
2024-11-01;Região de Saúde Alentejo;Unidade Local de Saúde do Litoral Alentejano;95216;0;0;0;95216
2024-11-01;Região de Saúde Norte;Unidade Local de Saúde do Médio Ave;79321;30212;6694;0;116227
2024-12-01;Região de Saúde LVT;Hospital de Cascais;89538;49403;16801;845;156587
2024-12-01;Região de Saúde LVT;Unidade Local de Saúde da Arrábida;75143;33460;7334;0;115937
2024-12-01;Região de Saúde Centro;Unidade Local de Saúde da Guarda;82015;16456;3973;0;102444
2024-12-01;Região de Saúde Norte;Unidade Local de Saúde de Barcelos/Esposende;52487;13295;0;0;65782
2024-12-01;Região de Saúde Centro;Unidade Local de Saúde de Dão-Lafões;117146;29204;14772;0;161122
2024-12-01;Região de Saúde LVT;Unidade Local de Saúde de Santa Maria;137347;50034;8748;0;196129
2024-12-01;Região de Saúde Norte;Unidade Local de Saúde de Santo António;126757;0;20048;0;146805
2024-12-01;Região de Saúde Algarve;Unidade Local de Saúde do Algarve;292003;72177;16579;0;380759
2024-12-01;Região de Saúde Norte;Unidade Local de Saúde do Médio Ave;86300;32923;7264;0;126487
2024-12-01;Região de Saúde LVT;Unidade Local de Saúde do Médio Tejo;120279;29468;4184;0;153931
2024-12-01;Região de Saúde Norte;Unidade Local de Saúde do Tâmega e Sousa;163456;36613;12646;0;212715
2024-01-01;Região de Saúde Centro;Unidade Local de Saúde da Região de Leiria;10042;2483;800;0;13325
2024-01-01;Região de Saúde LVT;Unidade Local de Saúde de Lisboa Ocidental;6569;2194;1288;0;10051
2024-01-01;Região de Saúde Norte;Unidade Local de Saúde de São João;12743;6129;1006;0;19878
2024-01-01;Região de Saúde LVT;Unidade Local de Saúde do Arco Ribeirinho;9228;1728;737;0;11693
2024-01-01;Região de Saúde Centro;Unidade Local de Saúde do Baixo Mondego;3994;1621;0;0;5615
2024-01-01;Região de Saúde LVT;Unidade Local de Saúde do Estuário do Tejo;6264;3721;690;0;10675
2025-01-01;Região de Saúde Centro;Unidade Local de Saúde da Cova da Beira;3960;1993;339;39;6331
2025-01-01;Região de Saúde Centro;Unidade Local de Saúde da Guarda;7223;1746;316;0;9285
2025-01-01;Região de Saúde Centro;Unidade Local de Saúde da Região de Aveiro;9872;3498;547;0;13917
2025-01-01;Região de Saúde Centro;Unidade Local de Saúde de Dão-Lafões;10900;2807;1130;0;14837
2025-01-01;Região de Saúde LVT;Unidade Local de Saúde de Lisboa Ocidental;7807;2765;1157;0;11729
2025-01-01;Região de Saúde LVT;Unidade Local de Saúde de Loures-Odivelas;5547;1950;959;0;8456
2025-01-01;Região de Saúde Algarve;Unidade Local de Saúde do Algarve;23862;6775;1042;0;31679
2025-01-01;Região de Saúde Alentejo;Unidade Local de Saúde do Alto Alentejo;6809;943;222;0;7974
2025-01-01;Região de Saúde Centro;Unidade Local de Saúde do Baixo Mondego;3966;1645;0;0;5611
2025-01-01;Região de Saúde Norte;Unidade Local de Saúde do Médio Ave;6499;1923;579;0;9001
2024-02-01;Região de Saúde Centro;Unidade Local de Saúde Castelo Branco;8311;2905;374;0;11590
2024-02-01;Região de Saúde Centro;Unidade Local de Saúde da Cova da Beira;7475;2732;615;42;10864
2024-02-01;Região de Saúde Centro;Unidade Local de Saúde da Guarda;12559;2464;656;0;15679
2024-02-01;Região de Saúde LVT;Unidade Local de Saúde da Lezíria;11627;4642;1119;0;17388
2024-02-01;Região de Saúde Norte;Unidade Local de Saúde de Braga;23139;8502;1950;0;33591
2024-02-01;Região de Saúde Centro;Unidade Local de Saúde de Coimbra;31147;11059;3757;0;45963
2024-02-01;Região de Saúde Norte;Unidade Local de Saúde de São João;25885;12832;1933;0;40650
2024-02-01;Região de Saúde Alentejo;Unidade Local de Saúde do Alentejo Central;7158;2344;0;0;9502
2024-02-01;Região de Saúde Algarve;Unidade Local de Saúde do Algarve;42561;11261;2795;0;56617
2024-02-01;Região de Saúde Alentejo;Unidade Local de Saúde do Baixo Alentejo;15052;2958;683;0;18693
2025-02-01;Região de Saúde Centro;Unidade Local de Saúde Castelo Branco;8210;2785;409;54;11458
2025-02-01;Região de Saúde LVT;Unidade Local de Saúde da Lezíria;12980;4590;1012;0;18582
2025-02-01;Região de Saúde Norte;Unidade Local de Saúde da Póvoa de Varzim/Vila do Conde;10998;0;0;0;10998
2025-02-01;Região de Saúde Norte;Unidade Local de Saúde de Entre Douro e Vouga;21602;3747;972;0;26321
2025-02-01;Região de Saúde Alentejo;Unidade Local de Saúde do Alto Alentejo;12766;1721;402;0;14889
2025-02-01;Região de Saúde LVT;Unidade Local de Saúde do Arco Ribeirinho;17992;4941;1205;0;24138
2025-02-01;Região de Saúde Centro;Unidade Local de Saúde do Baixo Mondego;7586;3077;0;0;10663
2024-03-01;Região de Saúde LVT;Unidade Local de Saúde de São José;31917;21280;5921;1502;60620
2024-03-01;Região de Saúde Alentejo;Unidade Local de Saúde do Alto Alentejo;19144;2274;624;0;22042
2024-03-01;Região de Saúde Alentejo;Unidade Local de Saúde do Baixo Alentejo;23065;4622;995;0;28682
2024-03-01;Região de Saúde LVT;Unidade Local de Saúde do Médio Tejo;27261;6924;926;0;35111
2024-04-01;Região de Saúde Centro;Unidade Local de Saúde Castelo Branco;17346;5875;751;0;23972
2024-04-01;Região de Saúde Centro;Unidade Local de Saúde da Guarda;23732;4988;1139;0;29859
2024-04-01;Região de Saúde LVT;Unidade Local de Saúde de Santa Maria;44204;16823;836;0;61863
2024-04-01;Região de Saúde Norte;Unidade Local de Saúde de Vila Nova de Gaia/Espinho;42360;14442;2714;0;59516
2024-04-01;Região de Saúde Norte;Unidade Local de Saúde do Alto Minho;45736;7660;2223;0;55619
2024-04-01;Região de Saúde Centro;Unidade Local de Saúde do Baixo Mondego;16668;7137;0;0;23805
2024-05-01;Região de Saúde LVT;Hospital de Cascais;34484;21118;6790;369;62761
2024-05-01;Região de Saúde Centro;Unidade Local de Saúde da Cova da Beira;20702;7671;1628;140;30141
2024-05-01;Região de Saúde Norte;Unidade Local de Saúde da Póvoa de Varzim/Vila do Conde;28934;0;0;0;28934
2024-05-01;Região de Saúde LVT;Unidade Local de Saúde de Amadora/Sintra;75970;22350;7258;0;105578
2024-05-01;Região de Saúde LVT;Unidade Local de Saúde de São José;56228;36995;10592;2609;106424
2024-05-01;Região de Saúde Norte;Unidade Local de Saúde de Trás-os-Montes e Alto Douro;79092;14425;2329;0;95846
2024-05-01;Região de Saúde Norte;Unidade Local de Saúde do Alto Minho;58550;9726;2786;0;71062
2024-06-01;Região de Saúde LVT;Unidade Local de Saúde da Arrábida;36009;16105;3558;0;55672
2024-06-01;Região de Saúde LVT;Unidade Local de Saúde de Santa Maria;69051;25286;1919;0;96256
2024-06-01;Região de Saúde Norte;Unidade Local de Saúde de Santo António;63145;0;10262;0;73407
2024-06-01;Região de Saúde LVT;Unidade Local de Saúde de São José;68346;43944;12540;3175;128005
2024-06-01;Região de Saúde Alentejo;Unidade Local de Saúde do Alto Alentejo;40098;4779;1342;0;46219
2024-06-01;Região de Saúde LVT;Unidade Local de Saúde do Arco Ribeirinho;58138;11117;3745;0;73000
2024-06-01;Região de Saúde Norte;Unidade Local de Saúde do Médio Ave;43680;18486;3557;0;65723
2024-07-01;Região de Saúde Centro;Unidade Local de Saúde da Cova da Beira;29337;10526;2320;231;42414
2024-07-01;Região de Saúde LVT;Unidade Local de Saúde da Lezíria;45321;18545;4397;0;68263
2024-07-01;Região de Saúde Centro;Unidade Local de Saúde da Região de Leiria;72382;15944;5295;0;93621
2024-07-01;Região de Saúde Norte;Unidade Local de Saúde de Barcelos/Esposende;31055;8751;0;0;39806
2024-07-01;Região de Saúde Norte;Unidade Local de Saúde de São João;100447;48742;7469;0;156658
2024-07-01;Região de Saúde LVT;Unidade Local de Saúde de São José;79128;49576;13869;3632;146205
2024-07-01;Região de Saúde Norte;Unidade Local de Saúde de Trás-os-Montes e Alto Douro;114279;19339;3168;0;136786
2024-07-01;Região de Saúde Alentejo;Unidade Local de Saúde do Litoral Alentejano;60622;0;0;0;60622
2024-07-01;Região de Saúde LVT;Unidade Local de Saúde do Médio Tejo;69511;16535;2469;0;88515
2024-07-01;Região de Saúde Norte;Unidade Local de Saúde do Nordeste;61593;0;0;0;61593
2024-08-01;Região de Saúde LVT;Hospital de Cascais;56048;31176;11035;562;98821
2024-08-01;Região de Saúde Centro;Unidade Local de Saúde de Coimbra;135855;45856;15804;0;197515
2024-08-01;Região de Saúde Norte;Unidade Local de Saúde de Matosinhos;55500;0;5951;0;61451
2024-08-01;Região de Saúde Norte;Unidade Local de Saúde de Santo António;85015;0;13626;0;98641
2024-08-01;Região de Saúde LVT;Unidade Local de Saúde de São José;91423;55513;16334;4255;167525
2024-08-01;Região de Saúde Norte;Unidade Local de Saúde de Vila Nova de Gaia/Espinho;88552;26022;5472;0;120046
2024-08-01;Região de Saúde Norte;Unidade Local de Saúde do Alto Minho;97680;14502;4662;0;116844
2024-08-01;Região de Saúde LVT;Unidade Local de Saúde do Arco Ribeirinho;76969;13221;5049;0;95239
2024-08-01;Região de Saúde Alentejo;Unidade Local de Saúde do Baixo Alentejo;63655;12726;2803;0;79184
2024-09-01;Região de Saúde LVT;Hospital de Cascais;63098;34580;12518;636;110832
2024-09-01;Região de Saúde LVT;Unidade Local de Saúde de Almada-Seixal;69844;28668;9863;0;108375
2024-09-01;Região de Saúde Norte;Unidade Local de Saúde de Braga;114940;36049;8602;0;159591
2024-09-01;Região de Saúde LVT;Unidade Local de Saúde de Santa Maria;104270;35525;5198;0;144993
2024-09-01;Região de Saúde Centro;Unidade Local de Saúde do Baixo Mondego;39031;14938;0;0;53969
2024-09-01;Região de Saúde LVT;Unidade Local de Saúde do Oeste;89588;36806;4740;0;131134
2024-10-01;Região de Saúde LVT;Hospital de Cascais;74632;40019;14268;739;129658
2024-10-01;Região de Saúde Centro;Unidade Local de Saúde Castelo Branco;44868;13828;1970;0;60666
2024-10-01;Região de Saúde LVT;Unidade Local de Saúde da Arrábida;62268;25835;6285;0;94388
2024-10-01;Região de Saúde LVT;Unidade Local de Saúde da Lezíria;64522;24874;6289;0;95685
2024-10-01;Região de Saúde Norte;Unidade Local de Saúde de Santo António;106448;0;16978;0;123426
2024-10-01;Região de Saúde LVT;Unidade Local de Saúde de São José;114911;68439;20643;5304;209297
2024-10-01;Região de Saúde Norte;Unidade Local de Saúde de Trás-os-Montes e Alto Douro;164172;25807;4520;0;194499
2024-10-01;Região de Saúde Algarve;Unidade Local de Saúde do Algarve;246637;60885;14306;0;321828
2024-10-01;Região de Saúde Norte;Unidade Local de Saúde do Alto Ave;87386;30157;8700;0;126243
2024-10-01;Região de Saúde Norte;Unidade Local de Saúde do Alto Minho;121496;17487;5850;0;144833
2024-10-01;Região de Saúde Norte;Unidade Local de Saúde do Tâmega e Sousa;135583;30436;10817;0;176836
2024-11-01;Região de Saúde LVT;Unidade Local de Saúde da Arrábida;68633;29496;6822;0;104951
2024-11-01;Região de Saúde Centro;Unidade Local de Saúde de Coimbra;185366;62150;21474;0;268990
2024-11-01;Região de Saúde LVT;Unidade Local de Saúde de Loures-Odivelas;65508;22759;13102;0;101369
2024-11-01;Região de Saúde Norte;Unidade Local de Saúde do Alto Ave;96174;33523;9522;0;139219
2024-11-01;Região de Saúde Norte;Unidade Local de Saúde do Alto Minho;131646;19251;6318;0;157215
2024-11-01;Região de Saúde LVT;Unidade Local de Saúde do Arco Ribeirinho;105186;19869;6829;0;131884
2024-11-01;Região de Saúde LVT;Unidade Local de Saúde do Oeste;109722;47076;6146;0;162944
2024-12-01;Região de Saúde Centro;Unidade Local de Saúde da Região de Aveiro;123623;47138;6670;0;177431
2024-12-01;Região de Saúde Norte;Unidade Local de Saúde de Matosinhos;82614;0;8889;0;91503
2024-12-01;Região de Saúde Norte;Unidade Local de Saúde de São João;170896;81958;12737;0;265591
2024-12-01;Região de Saúde Norte;Unidade Local de Saúde de Trás-os-Montes e Alto Douro;194944;32103;5385;0;232432
2024-12-01;Região de Saúde LVT;Unidade Local de Saúde do Arco Ribeirinho;114431;22324;7543;0;144298
2024-12-01;Região de Saúde Alentejo;Unidade Local de Saúde do Baixo Alentejo;94094;18578;4213;0;116885
2024-12-01;Região de Saúde Centro;Unidade Local de Saúde do Baixo Mondego;50966;20007;0;0;70973
2024-12-01;Região de Saúde Norte;Unidade Local de Saúde do Nordeste;106369;0;0;0;106369
